Label,StartPoint,EndPoint,Size,log_2,
empty,1,335,334,9,
indexTable,335,565,230,8,
stepsizeTable,565,1700,1135,11,
adpcm_coder,1700,2151,451,9,
.LPIC0,2151,2286,135,8,
.L15,2286,2619,333,9,
.L3,2619,2949,330,9,
.L4,2949,3269,320,9,
.L5,3269,3515,246,8,
.L6,3515,3641,126,7,
.L7,3641,3719,78,7,
.L8,3719,3812,93,7,
.L9,3812,3913,101,7,
.L10,3913,4009,96,7,
.LPIC1,4009,4213,204,8,
.L11,4213,4294,81,7,
.L12,4294,4316,22,5,
.LPIC2,4316,4529,213,8,
.L13,4529,4729,200,8,
.L14,4729,4887,158,8,
.L2,4887,5075,188,8,
.L16,5075,5288,213,8,
.L18,5288,5304,16,4,
.L17,5304,5556,252,8,
adpcm_decoder,5556,6009,453,9,
.LPIC3,6009,6145,136,8,
.L32,6145,6255,110,7,
.L21,6255,6423,168,8,
.L22,6423,6544,121,7,
.LPIC4,6544,6748,204,8,
.L23,6748,6829,81,7,
.L24,6829,7128,299,9,
.L25,7128,7281,153,8,
.L26,7281,7434,153,8,
.L27,7434,7563,129,8,
.L28,7563,7642,79,7,
.L29,7642,7737,95,7,
.L30,7737,7839,102,7,
.L31,7839,7861,22,5,
.LPIC5,7861,8120,259,9,
.L20,8120,8373,253,8,
.L34,8373,8389,16,4,
.L33,8389,8395,137,8,
end,end,end,end,


LineNum,inLabel,command,JumpToLabel,jumpToAd,start_row_counter,
Label,StartPoint,EndPoint,Size,log_2,
empty,1,307,306,9,
.LC0,307,375,68,7,
.LC1,375,381,6,3,
	.ascii	"Solutions,381,416,35,6,
.LC2,416,450,34,6,
.LC3,450,520,70,7,
.LC4,520,570,50,6,
.LC5,570,619,49,6,
.LC6,619,688,69,7,
.LC7,688,752,64,6,
.LC8,752,783,31,5,
.LC9,783,945,162,8,
main,945,1104,159,8,
.LPIC0,1104,1532,428,9,
.LPIC1,1532,1761,229,8,
.LPIC2,1761,1847,86,7,
.L3,1847,1971,124,7,
.LPIC3,1971,2072,101,7,
.L2,2072,2584,512,9,
.LPIC4,2584,2670,86,7,
.L5,2670,2794,124,7,
.LPIC5,2794,2895,101,7,
.L4,2895,3407,512,9,
.LPIC6,3407,3493,86,7,
.L7,3493,3617,124,7,
.LPIC7,3617,3718,101,7,
.L6,3718,4226,508,9,
.LPIC8,4226,4312,86,7,
.L9,4312,4436,124,7,
.LPIC9,4436,4537,101,7,
.L8,4537,5041,504,9,
.LPIC10,5041,5129,88,7,
.L11,5129,5254,125,7,
.LPIC11,5254,5356,102,7,
.L10,5356,5854,498,9,
.LPIC12,5854,5942,88,7,
.L13,5942,6067,125,7,
.LPIC13,6067,6169,102,7,
.L12,6169,6679,510,9,
.LPIC14,6679,6767,88,7,
.L15,6767,6892,125,7,
.LPIC15,6892,6994,102,7,
.L14,6994,7494,500,9,
.LPIC16,7494,7582,88,7,
.L17,7582,7707,125,7,
.LPIC17,7707,7809,102,7,
.L16,7809,7968,159,8,
.L27,7968,8042,74,7,
.L26,8042,8116,74,7,
.L25,8116,8190,74,7,
.L24,8190,8379,189,8,
.LPIC18,8379,8467,88,7,
.L23,8467,8592,125,7,
.LPIC19,8592,8694,102,7,
.L22,8694,8870,176,8,
.L21,8870,9060,190,8,
.L20,9060,9251,191,8,
.L19,9251,9420,169,8,
.L18,9420,9540,120,7,
.LPIC20,9540,9626,86,7,
.L29,9626,9773,147,8,
.LPIC21,9773,9875,102,7,
.L28,9875,10038,163,8,
.L31,10038,10173,135,8,
.LPIC22,10173,10275,102,7,
.L30,10275,10372,97,7,
.LPIC23,10372,10471,99,7,
.L33,10471,10640,169,8,
.LPIC24,10640,10777,137,8,
.L32,10777,10896,119,7,
.LPIC25,10896,10995,99,7,
.L35,10995,11164,169,8,
.LPIC26,11164,11301,137,8,
.L34,11301,11544,243,8,
.L37,11544,11612,68,7,
.L39,11612,11628,16,4,
.L38,11628,11634,1234,11,
end,end,end,end,


LineNum,inLabel,command,JumpToLabel,jumpToAd,start_row_counter,
Label,StartPoint,EndPoint,Size,log_2,
empty,1,294,293,9,
.LC0,294,300,6,3,
	.ascii	"Usage,300,368,68,7,
.LC1,368,434,66,7,
.LC2,434,479,45,6,
.LC3,479,511,32,5,
.LC4,511,641,130,8,
main,641,915,274,9,
.LPIC0,915,1285,370,9,
.LPIC1,1285,1358,73,7,
.L2,1358,1636,278,9,
.L3,1636,1692,56,6,
.L4,1692,1970,278,9,
.L6,1970,2026,56,6,
.L7,2026,2048,22,5,
.LPIC2,2048,2121,73,7,
.L5,2121,2250,129,8,
.L13,2250,2902,652,10,
.L9,2902,3315,413,9,
.L11,3315,3338,23,5,
.LPIC3,3338,3411,73,7,
.L10,3411,3830,419,9,
.L8,3830,4011,181,8,
.L12,4011,4255,244,8,
.LPIC4,4255,4328,73,7,
.L14,4328,4466,138,8,
.LPIC5,4466,4627,161,8,
.LPIC6,4627,4700,73,7,
.L15,4700,4839,139,8,
.LPIC7,4839,5000,161,8,
.LPIC8,5000,5073,73,7,
.L16,5073,5148,75,7,
.L20,5148,5432,284,9,
.L18,5432,5606,174,8,
.L19,5606,6038,432,9,
.L22,6038,6382,344,9,
.L21,6382,6568,186,8,
.L17,6568,6826,258,9,
.L26,6826,6842,16,4,
.L25,6842,6848,280,9,
end,end,end,end,


LineNum,inLabel,command,JumpToLabel,jumpToAd,start_row_counter,
Label,StartPoint,EndPoint,Size,log_2,
empty,1,299,298,9,
.LC0,299,305,6,3,
	.ascii	"Usage,305,361,56,6,
.LC1,361,427,66,7,
.LC2,427,433,6,3,
	.ascii	"%-38s> Time,433,496,63,6,
.LC3,496,545,49,6,
.LC4,545,688,143,8,
main,688,876,188,8,
.LPIC0,876,1138,262,9,
.LPIC1,1138,1201,63,6,
.L2,1201,1313,112,7,
.LPIC2,1313,1398,85,7,
.L10,1398,1548,150,8,
.L5,1548,1570,22,5,
.LPIC3,1570,1851,281,9,
.L4,1851,2282,431,9,
.L6,2282,2461,179,8,
.L8,2461,2483,22,5,
.LPIC4,2483,2630,147,8,
.LPIC5,2630,2721,91,7,
.L3,2721,2784,63,6,
.LPIC6,2784,2890,106,7,
.LPIC7,2890,2955,65,7,
.LPIC8,2955,3061,106,7,
.LPIC9,3061,3195,134,8,
.L15,3195,3211,16,4,
.L14,3211,3651,440,9,
bit_shifter,3651,3919,268,9,
.L19,3919,4119,200,8,
.L17,4119,4206,87,7,
.L18,4206,4451,245,8,
pBitCntFunc.7377,4451,4637,186,8,
.LC5,4637,4696,59,6,
.LC6,4696,4752,56,6,
.LC7,4752,4813,61,6,
.LC8,4813,4878,65,7,
.LC9,4878,4946,68,7,
.LC10,4946,5015,69,7,
.LC11,5015,5155,140,8,
text.7378,5155,5166,97,7,
end,end,end,end,


LineNum,inLabel,command,JumpToLabel,jumpToAd,start_row_counter,
Label,StartPoint,EndPoint,Size,log_2,
empty,1,294,293,9,
.LC0,294,300,6,3,
	.ascii	"Usage,300,368,68,7,
.LC1,368,434,66,7,
.LC2,434,479,45,6,
.LC3,479,511,32,5,
.LC4,511,641,130,8,
main,641,915,274,9,
.LPIC0,915,1285,370,9,
.LPIC1,1285,1358,73,7,
.L2,1358,1636,278,9,
.L3,1636,1692,56,6,
.L4,1692,1970,278,9,
.L6,1970,2026,56,6,
.L7,2026,2048,22,5,
.LPIC2,2048,2121,73,7,
.L5,2121,2250,129,8,
.L13,2250,2902,652,10,
.L9,2902,3315,413,9,
.L11,3315,3338,23,5,
.LPIC3,3338,3411,73,7,
.L10,3411,3830,419,9,
.L8,3830,4011,181,8,
.L12,4011,4255,244,8,
.LPIC4,4255,4328,73,7,
.L14,4328,4466,138,8,
.LPIC5,4466,4627,161,8,
.LPIC6,4627,4700,73,7,
.L15,4700,4839,139,8,
.LPIC7,4839,5000,161,8,
.LPIC8,5000,5073,73,7,
.L16,5073,5148,75,7,
.L20,5148,5432,284,9,
.L18,5432,5606,174,8,
.L19,5606,6038,432,9,
.L22,6038,6382,344,9,
.L21,6382,6568,186,8,
.L17,6568,6826,258,9,
.L26,6826,6842,16,4,
.L25,6842,6848,280,9,
end,end,end,end,


LineNum,inLabel,command,JumpToLabel,jumpToAd,start_row_counter,
Label,StartPoint,EndPoint,Size,log_2,
empty,1,338,337,9,
crc_32_tab,338,5070,4732,13,
updateCRC32,5070,5382,312,9,
.LPIC0,5382,5556,174,8,
.L4,5556,5571,15,4,
.L3,5571,5667,96,7,
.LC0,5667,5807,140,8,
crc32file,5807,6087,280,9,
.LPIC1,6087,6241,154,8,
.L9,6241,6386,145,8,
.LPIC2,6386,6465,79,7,
.L8,6465,6676,211,8,
.L10,6676,6768,92,7,
.L7,6768,6854,86,7,
.L12,6854,6870,16,4,
.L11,6870,7067,197,8,
crc32buf,7067,7292,225,8,
.L15,7292,7394,102,7,
.LPIC3,7394,7571,177,8,
.L14,7571,7701,130,8,
.L18,7701,7717,16,4,
.L17,7717,7808,91,7,
.LC1,7808,7954,146,8,
main,7954,8144,190,8,
.LPIC4,8144,8252,108,7,
.L21,8252,8507,255,8,
.LPIC5,8507,8543,36,6,
.L20,8543,8830,287,9,
.L23,8830,8901,71,7,
.L25,8901,8917,16,4,
.L24,8917,8923,119,7,
end,end,end,end,


LineNum,inLabel,command,JumpToLabel,jumpToAd,start_row_counter,
Label,StartPoint,EndPoint,Size,log_2,
empty,1,347,346,9,
qHead,347,461,114,7,
g_qCount,461,626,165,8,
.LC0,626,770,144,8,
print_path,770,960,190,8,
.LPIC1,960,1233,273,9,
.L2,1233,1267,34,6,
.LPIC0,1267,1456,189,8,
.L4,1456,1471,15,4,
.L3,1471,1618,147,8,
.LC1,1618,1771,153,8,
enqueue,1771,1983,212,8,
.LPIC3,1983,2080,97,7,
.LPIC2,2080,2265,185,8,
.LPIC4,2265,2328,63,6,
.L6,2328,2603,275,9,
.LPIC5,2603,2675,72,7,
.L10,2675,2738,63,6,
.L9,2738,2860,122,7,
.L8,2860,2882,22,5,
.LPIC6,2882,2950,68,7,
.LPIC7,2950,3050,100,7,
.L12,3050,3066,16,4,
.L11,3066,3389,323,9,
dequeue,3389,3597,208,8,
.LPIC8,3597,3666,69,7,
.LPIC9,3666,3738,72,7,
.LPIC10,3738,3837,99,7,
.LPIC11,3837,3939,102,7,
.LPIC12,3939,4041,102,7,
.LPIC13,4041,4112,71,7,
.LPIC14,4112,4197,85,7,
.LPIC15,4197,4266,69,7,
.LPIC16,4266,4301,35,6,
.L15,4301,4369,68,7,
.L17,4369,4385,16,4,
.L16,4385,4751,366,9,
qcount,4751,4915,164,8,
.LPIC17,4915,5012,97,7,
.L21,5012,5028,16,4,
.L20,5028,5114,86,7,
.LC2,5114,5208,94,7,
.LC3,5208,5268,60,6,
.LC4,5268,5274,6,3,
	.ascii	"Path is,5274,5414,140,8,
dijkstra,5414,5603,189,8,
.LPIC18,5603,5705,102,7,
.L24,5705,6109,404,9,
.L23,6109,6257,148,8,
.LPIC19,6257,6312,55,6,
.L25,6312,6624,312,9,
.L32,6624,6870,246,8,
.L31,6870,7622,752,10,
.L30,7622,8276,654,10,
.L29,8276,8397,121,7,
.L28,8397,8475,78,7,
.L27,8475,8646,171,8,
.LPIC20,8646,8712,66,7,
.LPIC21,8712,8872,160,8,
.L26,8872,8956,84,7,
.L34,8956,8972,16,4,
.L33,8972,9291,319,9,
.LC5,9291,9297,6,3,
	.ascii	"Usage,9297,9352,55,6,
.LC6,9352,9426,74,7,
.LC7,9426,9458,32,5,
.LC8,9458,9589,131,8,
main,9589,9775,186,8,
.LPIC22,9775,9995,220,8,
.LPIC23,9995,10124,129,8,
.LPIC24,10124,10161,37,6,
.L36,10161,10229,68,7,
.LPIC25,10229,10348,119,7,
.L40,10348,10394,46,6,
.L39,10394,10446,52,6,
.LPIC26,10446,10755,309,9,
.L38,10755,10858,103,7,
.L37,10858,10979,121,7,
.L42,10979,11344,365,9,
.L41,11344,11419,75,7,
.L45,11419,11435,16,4,
.L44,11435,11441,234,8,
end,end,end,end,


LineNum,inLabel,command,JumpToLabel,jumpToAd,start_row_counter,
Label,StartPoint,EndPoint,Size,log_2,
empty,1,388,387,9,
IsPowerOfTwo,388,638,250,8,
.L2,638,754,116,7,
.L4,754,772,18,5,
.L3,772,921,149,8,
.LC0,921,927,6,3,
	.ascii	">>> Error in fftmisc.c,927,1164,237,8,
NumberOfBitsNeeded,1164,1346,182,8,
.LPIC0,1346,1487,141,8,
.LPIC1,1487,1563,76,7,
.L6,1563,1600,37,6,
.L9,1600,1748,148,8,
.L7,1748,1815,67,7,
.L10,1815,1890,75,7,
.L12,1890,1906,16,4,
.L11,1906,2157,251,8,
ReverseBits,2157,2439,282,9,
.L15,2439,2657,218,8,
.L14,2657,2979,322,9,
Index_to_frequency,2979,3270,291,9,
.L18,3270,3492,222,8,
.L20,3492,3687,195,8,
.L19,3687,3778,91,7,
.L22,3778,3794,16,4,
.L21,3794,3800,72,7,
end,end,end,end,


LineNum,inLabel,command,JumpToLabel,jumpToAd,start_row_counter,
Label,StartPoint,EndPoint,Size,log_2,
empty,1,490,489,9,
.LC0,490,496,6,3,
	.ascii	"Warning,496,721,225,8,
lame_init_params,721,909,188,8,
.LPIC2,909,974,65,7,
.LPIC0,974,1067,93,7,
.LPIC1,1067,1302,235,8,
.L2,1302,1467,165,8,
.L3,1467,1739,272,9,
.L5,1739,1880,141,8,
.L7,1880,2007,127,7,
.L8,2007,2148,141,8,
.L9,2148,2290,142,8,
.L10,2290,2349,59,6,
.L6,2349,3346,997,10,
.L12,3346,3489,143,8,
.L13,3489,3632,143,8,
.L14,3632,3761,129,8,
.L15,3761,3904,143,8,
.L16,3904,3964,60,6,
.L4,3964,4066,102,7,
.L130,4066,4083,17,5,
.L129,4083,4231,148,8,
.L17,4231,4250,19,5,
.L18,4250,4674,424,9,
.L19,4674,5068,394,9,
.L20,5068,5611,543,10,
.L21,5611,6279,668,10,
.L22,6279,6553,274,9,
.L24,6553,7375,822,10,
.L26,7375,8095,720,10,
.L28,8095,8367,272,9,
.L29,8367,8522,155,8,
.L124,8522,8575,53,6,
.L32,8575,8776,201,8,
.L125,8776,8829,53,6,
.L35,8829,8881,52,6,
.L27,8881,9755,874,10,
.L37,9755,10027,272,9,
.L40,10027,10182,155,8,
.L126,10182,10235,53,6,
.L43,10235,10436,201,8,
.L127,10436,10489,53,6,
.L46,10489,10541,52,6,
.L36,10541,10808,267,9,
.L132,10808,10825,17,5,
.L131,10825,10967,142,8,
.L56,10967,11471,504,9,
.L51,11471,12293,822,10,
.L53,12293,12354,61,6,
.L50,12354,12697,343,9,
.L57,12697,12915,218,8,
.L58,12915,13109,194,8,
.L48,13109,13558,449,9,
.LPIC3,13558,13594,36,6,
.L59,13594,13801,207,8,
.L69,13801,14305,504,9,
.L64,14305,15124,819,10,
.L66,15124,15185,61,6,
.L63,15185,15702,517,10,
.L70,15702,15920,218,8,
.L47,15920,16057,137,8,
.L71,16057,16076,19,5,
.L72,16076,16463,387,9,
.L73,16463,16839,376,9,
.L74,16839,17128,289,9,
.L77,17128,17245,117,7,
.L78,17245,17362,117,7,
.L79,17362,17486,124,7,
.L76,17486,17862,376,9,
.L81,17862,17986,124,7,
.L82,17986,18362,376,9,
.L134,18362,18379,17,5,
.L133,18379,18464,85,7,
.L75,18464,18648,184,8,
.L83,18648,18763,115,7,
.L84,18763,18878,115,7,
.L85,18878,19089,211,8,
.L86,19089,19250,161,8,
.L87,19250,19328,78,7,
.L88,19328,19443,115,7,
.L89,19443,19466,23,5,
.LPIC4,19466,19890,424,9,
.L90,19890,20005,115,7,
.L91,20005,20376,371,9,
.L92,20376,20491,115,7,
.L93,20491,20862,371,9,
.L94,20862,20977,115,7,
.L95,20977,21092,115,7,
.L96,21092,21463,371,9,
.L97,21463,21834,371,9,
.L98,21834,22232,398,9,
.L99,22232,22278,46,6,
.L101,22278,22704,426,9,
.L100,22704,22793,89,7,
.L103,22793,23305,512,9,
.L102,23305,23561,256,8,
.LPIC5,23561,23606,45,6,
.L128,23606,23679,73,7,
.L136,23679,23696,17,5,
.L135,23696,23886,190,8,
.LC1,23886,23998,112,7,
.LC2,23998,24004,6,3,
	.ascii	"Resampling,24004,24071,67,7,
.LC3,24071,24077,6,3,
	.ascii	"Using polyphase highpass filter, transition band,24077,24185,108,7,
.LC4,24185,24191,6,3,
	.ascii	"Using polyphase lowpass filter,  transition band,24191,24299,108,7,
.LC5,24299,24347,48,6,
.LC6,24347,24379,32,5,
.LC7,24379,24415,36,6,
.LC8,24415,24452,37,6,
.LC9,24452,24504,52,6,
.LC10,24504,24608,104,7,
.LC11,24608,24844,236,8,
lame_print_config,24844,25042,198,8,
.LPIC6,25042,25921,879,10,
.LPIC7,25921,25957,36,6,
.L138,25957,26285,328,9,
.LPIC8,26285,26322,37,6,
.L139,26322,26846,524,10,
.LPIC9,26846,26883,37,6,
.L140,26883,27407,524,10,
.LPIC10,27407,27445,38,6,
.L142,27445,27630,185,8,
.LPIC11,27630,27689,59,6,
.L144,27689,27802,113,7,
.LPIC12,27802,27945,143,8,
.L146,27945,27970,25,5,
.LPIC13,27970,28003,33,6,
.L147,28003,28066,63,6,
.LPIC14,28066,28209,143,8,
.L148,28209,28234,25,5,
.LPIC15,28234,28255,21,5,
.L149,28255,28292,37,6,
.LPIC16,28292,28663,371,9,
.LPIC17,28663,28905,242,8,
.LPIC18,28905,28964,59,6,
.L150,28964,29232,268,9,
.LPIC19,29232,29543,311,9,
.LPIC20,29543,29593,50,6,
.L145,29593,29752,159,8,
.L154,29752,29769,17,5,
.L153,29769,30311,542,10,
.LC12,30311,30349,38,6,
.LC13,30349,30498,149,8,
.LC14,30498,30692,194,8,
lame_encode_frame,30692,31193,501,9,
.LPIC21,31193,32477,1284,11,
.LPIC22,32477,32555,78,7,
.LPIC23,32555,32810,255,8,
.LPIC24,32810,33279,469,9,
.LPIC25,33279,33336,57,6,
.LPIC26,33336,33483,147,8,
.LPIC27,33483,33555,72,7,
.L157,33555,33580,25,5,
.LPIC28,33580,33654,74,7,
.LPIC29,33654,33792,138,8,
.LPIC30,33792,33963,171,8,
.L204,33963,34146,183,8,
.LPIC31,34146,34200,54,6,
.LPIC32,34200,34239,39,6,
.LPIC33,34239,34283,44,6,
.L156,34283,34412,129,8,
.L161,34412,34509,97,7,
.L162,34509,34606,97,7,
.L207,34606,34793,187,8,
.L164,34793,34980,187,8,
.L165,34980,35005,25,5,
.LPIC34,35005,35113,108,7,
.LPIC35,35113,35213,100,7,
.LPIC36,35213,35322,109,7,
.LPIC37,35322,35379,57,6,
.LPIC38,35379,35457,78,7,
.LPIC39,35457,35586,129,8,
.L208,35586,35692,106,7,
.LPIC40,35692,35793,101,7,
.LPIC41,35793,35872,79,7,
.LPIC42,35872,35911,39,6,
.L163,35911,36213,302,9,
.L169,36213,36234,21,5,
.L170,36234,36774,540,10,
.L168,36774,37013,239,8,
.LPIC43,37013,37170,157,8,
.L177,37170,37250,80,7,
.L210,37250,37267,17,5,
.L209,37267,38135,868,10,
.L174,38135,38622,487,9,
.L173,38622,38856,234,8,
.LPIC44,38856,38979,123,7,
.LPIC45,38979,39857,878,10,
.L176,39857,40025,168,8,
.LPIC46,40025,40405,380,9,
.L175,40405,40673,268,9,
.L172,40673,40831,158,8,
.L171,40831,40911,80,7,
.L182,40911,40991,80,7,
.L181,40991,41016,25,5,
.LPIC47,41016,41674,658,10,
.L180,41674,41942,268,9,
.L179,41942,42091,149,8,
.L178,42091,42171,80,7,
.L188,42171,42251,80,7,
.L187,42251,42511,260,9,
.LPIC48,42511,42847,336,9,
.L185,42847,42937,90,7,
.L186,42937,43063,126,7,
.L184,43063,43331,268,9,
.L183,43331,43692,361,9,
.LPIC49,43692,44032,340,9,
.LPIC50,44032,44090,58,6,
.LPIC51,44090,44172,82,7,
.LPIC52,44172,44231,59,6,
.LPIC53,44231,44317,86,7,
.L190,44317,44337,20,5,
.L191,44337,44395,58,6,
.L189,44395,44494,99,7,
.LPIC54,44494,44551,57,6,
.LPIC55,44551,44883,332,9,
.LPIC56,44883,44940,57,6,
.LPIC57,44940,45309,369,9,
.L192,45309,45487,178,8,
.L194,45487,45787,300,9,
.L195,45787,45971,184,8,
.L196,45971,46337,366,9,
.LPIC58,46337,46471,134,8,
.LPIC59,46471,46557,86,7,
.L197,46557,46833,276,9,
.LPIC60,46833,46967,134,8,
.LPIC61,46967,47040,73,7,
.L198,47040,47347,307,9,
.LPIC62,47347,47454,107,7,
.LPIC63,47454,47537,83,7,
.LPIC64,47537,47595,58,6,
.LPIC65,47595,47665,70,7,
.LPIC66,47665,47719,54,6,
.LPIC67,47719,47773,54,6,
.LPIC68,47773,47963,190,8,
.LPIC69,47963,48017,54,6,
.LPIC70,48017,48071,54,6,
.LPIC71,48071,48196,125,7,
.LPIC72,48196,48250,54,6,
.LPIC73,48250,48404,154,8,
.LPIC74,48404,48454,50,6,
.L199,48454,48480,26,5,
.LPIC75,48480,48534,54,6,
.LPIC76,48534,48604,70,7,
.LPIC77,48604,48730,126,7,
.LPIC78,48730,48960,230,8,
.LPIC79,48960,49045,85,7,
.L200,49045,49419,374,9,
.L202,49419,49519,100,7,
.L212,49519,49536,17,5,
.L211,49536,50918,1382,11,
fill_buffer_resample,50918,51271,353,9,
.LPIC80,51271,51391,120,7,
.LPIC81,51391,51501,110,7,
.LPIC82,51501,51694,193,8,
.LPIC83,51694,51786,92,7,
.L214,51786,51873,87,7,
.LPIC84,51873,51965,92,7,
.L215,51965,52403,438,9,
.L231,52403,52603,200,8,
.LPIC85,52603,52958,355,9,
.LPIC86,52958,53396,438,9,
.LPIC87,53396,53547,151,8,
.L219,53547,53636,89,7,
.L220,53636,53775,139,8,
.LPIC88,53775,53926,151,8,
.L221,53926,54032,106,7,
.L222,54032,54580,548,10,
.L223,54580,54878,298,9,
.LPIC89,54878,55029,151,8,
.L225,55029,55161,132,8,
.L226,55161,55300,139,8,
.LPIC90,55300,55451,151,8,
.L227,55451,55557,106,7,
.L228,55557,56921,1364,11,
.L229,56921,57093,172,8,
.L230,57093,57225,132,8,
.L224,57225,57287,62,6,
.L216,57287,57363,76,7,
.L237,57363,57380,17,5,
.L236,57380,57770,390,9,
.L235,57770,57782,12,4,
.L218,57782,57927,145,8,
.LPIC91,57927,58322,395,9,
.LPIC92,58322,58467,145,8,
.L233,58467,58666,199,8,
.LPIC93,58666,58909,243,8,
.L232,58909,59067,158,8,
.L239,59067,59084,17,5,
.L238,59084,59352,268,9,
fill_buffer,59352,59899,547,10,
.LC15,59899,59948,49,6,
.LC16,59948,59995,47,6,
.LC17,59995,60164,169,8,
lame_encode_buffer,60164,60446,282,9,
.LPIC94,60446,60781,335,9,
.LPIC95,60781,60835,54,6,
.LPIC96,60835,60874,39,6,
.LPIC97,60874,60918,44,6,
.L243,60918,61005,87,7,
.LPIC98,61005,61110,105,7,
.LPIC99,61110,61177,67,7,
.LPIC100,61177,61256,79,7,
.LPIC101,61256,61337,81,7,
.LPIC102,61337,61399,62,6,
.L244,61399,61486,87,7,
.LPIC103,61486,61547,61,6,
.L245,61547,61717,170,8,
.L248,61717,62258,541,10,
.L247,62258,62334,76,7,
.L262,62334,62446,112,7,
.L253,62446,62591,145,8,
.LPIC104,62591,62728,137,8,
.LPIC105,62728,63088,360,9,
.L251,63088,63113,25,5,
.LPIC106,63113,63250,137,8,
.LPIC107,63250,63558,308,9,
.L252,63558,63850,292,9,
.L250,63850,64028,178,8,
.LPIC108,64028,64117,89,7,
.LPIC109,64117,64171,54,6,
.LPIC110,64171,64251,80,7,
.LPIC111,64251,64306,55,6,
.LPIC112,64306,64346,40,6,
.LPIC113,64346,64391,45,6,
.L254,64391,64416,25,5,
.LPIC114,64416,64505,89,7,
.LPIC115,64505,64559,54,6,
.LPIC116,64559,64655,96,7,
.LPIC117,64655,64791,136,8,
.LPIC118,64791,64863,72,7,
.LPIC119,64863,65015,152,8,
.L256,65015,65185,170,8,
.LPIC120,65185,65296,111,7,
.LPIC121,65296,65351,55,6,
.LPIC122,65351,65462,111,7,
.LPIC123,65462,65539,77,7,
.L261,65539,65587,48,6,
.L260,65587,65687,100,7,
.LPIC124,65687,65834,147,8,
.LPIC125,65834,66063,229,8,
.L259,66063,66089,26,5,
.LPIC126,66089,66222,133,8,
.L258,66222,66310,88,7,
.L249,66310,66418,108,7,
.LPIC127,66418,66475,57,6,
.LPIC128,66475,66516,41,6,
.LPIC129,66516,66561,45,6,
.L263,66561,66587,26,5,
.L264,66587,66723,136,8,
.L265,66723,66791,68,7,
.L267,66791,66808,17,5,
.L266,66808,68188,1380,11,
lame_encode_buffer_interleaved,68188,68587,399,9,
.LPIC130,68587,68642,55,6,
.LPIC131,68642,68681,39,6,
.LPIC132,68681,68726,45,6,
.L269,68726,68975,249,8,
.L270,68975,69374,399,9,
.L273,69374,69403,29,5,
.L274,69403,69451,48,6,
.L276,69451,69902,451,9,
.L275,69902,70250,348,9,
.L272,70250,70337,87,7,
.LPIC133,70337,70443,106,7,
.LPIC134,70443,70511,68,7,
.LPIC135,70511,70590,79,7,
.LPIC136,70590,70671,81,7,
.LPIC137,70671,70733,62,6,
.L277,70733,70820,87,7,
.LPIC138,70820,70881,61,6,
.L278,70881,71051,170,8,
.L281,71051,71646,595,10,
.L280,71646,71722,76,7,
.L291,71722,71879,157,8,
.L284,71879,71986,107,7,
.LPIC139,71986,72091,105,7,
.LPIC140,72091,72253,162,8,
.LPIC141,72253,72358,105,7,
.LPIC142,72358,72489,131,8,
.L283,72489,72747,258,9,
.LPIC143,72747,72836,89,7,
.LPIC144,72836,72890,54,6,
.LPIC145,72890,72970,80,7,
.LPIC146,72970,73026,56,6,
.LPIC147,73026,73066,40,6,
.LPIC148,73066,73111,45,6,
.L285,73111,73136,25,5,
.LPIC149,73136,73225,89,7,
.LPIC150,73225,73279,54,6,
.LPIC151,73279,73375,96,7,
.LPIC152,73375,73506,131,8,
.LPIC153,73506,73577,71,7,
.LPIC154,73577,73729,152,8,
.L286,73729,73891,162,8,
.LPIC155,73891,74002,111,7,
.LPIC156,74002,74057,55,6,
.LPIC157,74057,74168,111,7,
.LPIC158,74168,74245,77,7,
.L290,74245,74293,48,6,
.L289,74293,74393,100,7,
.LPIC159,74393,74540,147,8,
.LPIC160,74540,74769,229,8,
.L288,74769,74795,26,5,
.LPIC161,74795,74928,133,8,
.L287,74928,75016,88,7,
.L282,75016,75124,108,7,
.LPIC162,75124,75181,57,6,
.LPIC163,75181,75222,41,6,
.LPIC164,75222,75267,45,6,
.L292,75267,75293,26,5,
.L271,75293,75369,76,7,
.L294,75369,75386,17,5,
.L293,75386,76686,1300,11,
lame_encode,76686,76913,227,8,
.LPIC165,76913,77263,350,9,
.LPIC166,77263,77418,155,8,
.L298,77418,77435,17,5,
.L297,77435,77669,234,8,
lame_init,77669,77872,203,8,
.LPIC167,77872,80769,2897,12,
.L301,80769,80786,17,5,
.L300,80786,81013,227,8,
lame_encode_finish,81013,81337,324,9,
.LPIC168,81337,81619,282,9,
.L307,81619,81924,305,9,
.L304,81924,82270,346,9,
.LPIC169,82270,82351,81,7,
.L305,82351,82700,349,9,
.LPIC170,82700,82840,140,8,
.LPIC171,82840,82876,36,6,
.L303,82876,82901,25,5,
.LPIC172,82901,83761,860,10,
.L308,83761,84094,333,9,
.L309,84094,84223,129,8,
.LPIC173,84223,84398,175,8,
.LPIC174,84398,84479,81,7,
.L310,84479,84666,187,8,
.LPIC175,84666,84774,108,7,
.L311,84774,84941,167,8,
.L312,84941,85014,73,7,
.L314,85014,85031,17,5,
.L313,85031,85511,480,9,
lame_mp3_tags,85511,85693,182,8,
.LPIC176,85693,86111,418,9,
.L316,86111,86378,267,9,
.L318,86378,86451,73,7,
.L320,86451,86468,17,5,
.L319,86468,86691,223,8,
lame_version,86691,87085,394,9,
.LC18,87085,87123,38,6,
.LC19,87123,87163,40,6,
.LC20,87163,87202,39,6,
.LC21,87202,87343,141,8,
mode_names.8838,87343,87711,368,9,
__PRETTY_FUNCTION__.8879,87711,88142,431,9,
__PRETTY_FUNCTION__.8967,88142,88347,205,8,
__PRETTY_FUNCTION__.8998,88347,88373,130,8,
end,end,end,end,


LineNum,inLabel,command,JumpToLabel,jumpToAd,start_row_counter,
Label,StartPoint,EndPoint,Size,log_2,
empty,1,358,357,9,
bit,358,851,493,9,
pat_count,851,1147,296,9,
.L4,1147,1650,503,9,
.L5,1650,1844,194,8,
insertR,1844,2290,446,9,
.L7,2290,2498,208,8,
.L9,2498,2521,23,5,
.L10,2521,2699,178,8,
.L11,2699,2724,25,5,
.L12,2724,2793,69,7,
.L8,2793,3138,345,9,
.L14,3138,3304,166,8,
.L15,3304,3329,25,5,
.L13,3329,3543,214,8,
pat_insert,3543,3855,312,9,
.L17,3855,3882,27,5,
.L18,3882,4052,170,8,
.L22,4052,4352,300,9,
.L20,4352,4396,44,6,
.L21,4396,4658,262,9,
.L26,4658,5152,494,9,
.L25,5152,5213,61,6,
.L24,5213,5589,376,9,
.L30,5589,5981,392,9,
.L28,5981,6177,196,8,
.L29,6177,6238,61,6,
.L27,6238,6490,252,8,
.L31,6490,6892,402,9,
.L23,6892,6938,46,6,
.L34,6938,6999,61,6,
.L32,6999,7246,247,8,
.L33,7246,7573,327,9,
.L35,7573,7725,152,8,
.L36,7725,7749,24,5,
.L19,7749,7973,224,8,
pat_remove,7973,8286,313,9,
.L38,8286,8313,27,5,
.L39,8313,8426,113,7,
.L43,8426,8800,374,9,
.L41,8800,8844,44,6,
.L42,8844,9087,243,8,
.L44,9087,9272,185,8,
.L46,9272,9422,150,8,
.L47,9422,9503,81,7,
.L50,9503,9841,338,9,
.L48,9841,9885,44,6,
.L49,9885,10257,372,9,
.L51,10257,10320,63,6,
.L52,10320,10714,394,9,
.L54,10714,10757,43,6,
.L55,10757,10809,52,6,
.L53,10809,11031,222,8,
.L57,11031,11074,43,6,
.L58,11074,11118,44,6,
.L56,11118,11282,164,8,
.L59,11282,11642,360,9,
.L60,11642,11701,59,6,
.L45,11701,11747,46,6,
.L64,11747,11983,236,8,
.L61,11983,12107,124,7,
.L69,12107,12118,11,4,
.L63,12118,12255,137,8,
.L65,12255,12489,234,8,
.L68,12489,12854,365,9,
.L67,12854,12915,61,6,
.L66,12915,13288,373,9,
.L40,13288,13508,220,8,
pat_search,13508,13809,301,9,
.L71,13809,13994,185,8,
.L73,13994,14256,262,9,
.L74,14256,14300,44,6,
.L75,14300,14603,303,9,
.L76,14603,14628,25,5,
.L72,14628,14634,107,7,
end,end,end,end,


LineNum,inLabel,command,JumpToLabel,jumpToAd,start_row_counter,
Label,StartPoint,EndPoint,Size,log_2,
empty,1,486,485,9,
init_search,486,706,220,8,
.LPIC0,706,779,73,7,
.L3,779,799,20,5,
.LPIC1,799,848,49,6,
.LPIC2,848,980,132,8,
.L2,980,1066,86,7,
.L5,1066,1087,21,5,
.LPIC3,1087,1289,202,8,
.LPIC4,1289,1390,101,7,
.L4,1390,1411,21,5,
.LPIC5,1411,1501,90,7,
.LPIC6,1501,1627,126,7,
.L7,1627,1642,15,4,
.L6,1642,1953,311,9,
strsearch,1953,2134,181,8,
.LPIC7,2134,2244,110,7,
.L12,2244,2266,22,5,
.L10,2266,2408,142,8,
.LPIC8,2408,2476,68,7,
.L11,2476,2519,43,6,
.LPIC9,2519,2570,51,6,
.LPIC10,2570,2709,139,8,
.LPIC11,2709,2853,144,8,
.L13,2853,2876,23,5,
.L9,2876,2934,58,6,
.L14,2934,3017,83,7,
.L17,3017,3033,16,4,
.L16,3033,3214,181,8,
.LC108,3214,3247,33,6,
.LC109,3247,3284,37,6,
.LC110,3284,3338,54,6,
.LC111,3338,3380,42,6,
.LC0,3380,3414,34,6,
.LC1,3414,3448,34,6,
.LC2,3448,3482,34,6,
.LC3,3482,3515,33,6,
.LC4,3515,3549,34,6,
.LC5,3549,3583,34,6,
.LC6,3583,3617,34,6,
.LC7,3617,3650,33,6,
.LC8,3650,3683,33,6,
.LC9,3683,3716,33,6,
.LC10,3716,3749,33,6,
.LC11,3749,3786,37,6,
.LC12,3786,3821,35,6,
.LC13,3821,3856,35,6,
.LC14,3856,3894,38,6,
.LC15,3894,3930,36,6,
.LC16,3930,3966,36,6,
.LC17,3966,4004,38,6,
.LC18,4004,4039,35,6,
.LC19,4039,4075,36,6,
.LC20,4075,4114,39,6,
.LC21,4114,4152,38,6,
.LC22,4152,4188,36,6,
.LC23,4188,4224,36,6,
.LC24,4224,4260,36,6,
.LC25,4260,4299,39,6,
.LC26,4299,4336,37,6,
.LC27,4336,4374,38,6,
.LC28,4374,4413,39,6,
.LC29,4413,4454,41,6,
.LC30,4454,4491,37,6,
.LC31,4491,4529,38,6,
.LC32,4529,4565,36,6,
.LC33,4565,4603,38,6,
.LC34,4603,4642,39,6,
.LC35,4642,4677,35,6,
.LC36,4677,4715,38,6,
.LC37,4715,4752,37,6,
.LC38,4752,4788,36,6,
.LC39,4788,4826,38,6,
.LC40,4826,4865,39,6,
.LC41,4865,4908,43,6,
.LC42,4908,4945,37,6,
.LC43,4945,4983,38,6,
.LC44,4983,5027,44,6,
.LC45,5027,5062,35,6,
.LC46,5062,5100,38,6,
.LC47,5100,5136,36,6,
.LC48,5136,5173,37,6,
.LC49,5173,5211,38,6,
.LC50,5211,5251,40,6,
.LC51,5251,5292,41,6,
.LC52,5292,5345,53,6,
.LC106,5345,6120,775,10,
.LC54,6120,6158,38,6,
.LC55,6158,6194,36,6,
.LC56,6194,6239,45,6,
.LC57,6239,6285,46,6,
.LC58,6285,6322,37,6,
.LC59,6322,6360,38,6,
.LC60,6360,6393,33,6,
.LC61,6393,6464,71,7,
.LC62,6464,6518,54,6,
.LC63,6518,6586,68,7,
.LC64,6586,6648,62,6,
.LC65,6648,6712,64,6,
.LC66,6712,6770,58,6,
.LC67,6770,6836,66,7,
.LC68,6836,6894,58,6,
.LC69,6894,6960,66,7,
.LC70,6960,7024,64,6,
.LC71,7024,7097,73,7,
.LC72,7097,7149,52,6,
.LC73,7149,7213,64,6,
.LC74,7213,7279,66,7,
.LC75,7279,7347,68,7,
.LC76,7347,7409,62,6,
.LC77,7409,7480,71,7,
.LC78,7480,7540,60,6,
.LC79,7540,7606,66,7,
.LC80,7606,7670,64,6,
.LC81,7670,7737,67,7,
.LC82,7737,7798,61,6,
.LC83,7798,7864,66,7,
.LC84,7864,7928,64,6,
.LC85,7928,7995,67,7,
.LC86,7995,8057,62,6,
.LC87,8057,8116,59,6,
.LC88,8116,8188,72,7,
.LC89,8188,8255,67,7,
.LC90,8255,8329,74,7,
.LC91,8329,8396,67,7,
.LC92,8396,8467,71,7,
.LC93,8467,8537,70,7,
.LC94,8537,8610,73,7,
.LC95,8610,8680,70,7,
.LC96,8680,8752,72,7,
.LC97,8752,8813,61,6,
.LC98,8813,8886,73,7,
.LC99,8886,8955,69,7,
.LC100,8955,9028,73,7,
.LC101,9028,9093,65,7,
.LC102,9093,9167,74,7,
.LC103,9167,9233,66,7,
.LC104,9233,9284,51,6,
.LC107,9284,10145,861,10,
main,10145,10305,160,8,
.LPIC12,10305,10410,105,7,
.LPIC13,10410,10549,139,8,
.LPIC14,10549,10684,135,8,
.L23,10684,11119,435,9,
.LPIC15,11119,11160,41,6,
.L20,11160,11183,23,5,
.LPIC16,11183,11216,33,6,
.L21,11216,11319,103,7,
.LPIC17,11319,11457,138,8,
.LPIC18,11457,11506,49,6,
.L22,11506,11612,106,7,
.L19,11612,11879,267,9,
.L25,11879,11950,71,7,
.L27,11950,11966,16,4,
.L26,11966,11972,253,8,
end,end,end,end,


LineNum,inLabel,command,JumpToLabel,jumpToAd,start_row_counter,
Label,StartPoint,EndPoint,Size,log_2,
empty,1,355,354,9,
rel_version,355,463,108,7,
rel_date,463,585,122,7,
PGP_EXTENSION,585,706,121,7,
ASC_EXTENSION,706,827,121,7,
SIG_EXTENSION,827,948,121,7,
BAK_EXTENSION,948,1046,98,7,
HLP_EXTENSION,1046,1176,130,8,
CONSOLE_FILENAME,1176,1281,105,7,
HELP_FILENAME,1281,1510,229,8,
verbose,1510,1575,65,7,
.LC0,1575,1616,41,6,
.LC1,1616,1651,35,6,
.LC2,1651,1686,35,6,
.LC3,1686,1722,36,6,
.LC4,1722,1757,35,6,
.LC5,1757,1792,35,6,
.LC6,1792,1831,39,6,
.LC7,1831,1870,39,6,
.LC8,1870,1909,39,6,
.LC9,1909,2039,130,8,
compressSig,2039,2200,161,8,
.LC10,2200,2237,37,6,
.LC11,2237,2272,35,6,
.LC12,2272,2307,35,6,
.LC13,2307,2342,35,6,
.LC14,2342,2377,35,6,
.LC15,2377,2414,37,6,
.LC16,2414,2450,36,6,
.LC17,2450,2492,42,6,
.LC18,2492,2527,35,6,
.LC19,2527,2564,37,6,
.LC20,2564,2599,35,6,
.LC21,2599,2715,116,7,
compressName,2715,2913,198,8,
.LC22,2913,2949,36,6,
.LC23,2949,2985,36,6,
.LC24,2985,3021,36,6,
.LC25,3021,3057,36,6,
.LC26,3057,3093,36,6,
.LC27,3093,3129,36,6,
.LC28,3129,3164,35,6,
.LC29,3164,3198,34,6,
.LC30,3198,3234,36,6,
.LC31,3234,3270,36,6,
.LC32,3270,3306,36,6,
.LC33,3306,3419,113,7,
compressExt,3419,3616,197,8,
.LC34,3616,3777,161,8,
compressSignature,3777,3987,210,8,
.L5,3987,4005,18,5,
.LPIC0,4005,4097,92,7,
.LPIC1,4097,4332,235,8,
.L3,4332,4392,60,6,
.L2,4392,4500,108,7,
.LPIC2,4500,4608,108,7,
.L6,4608,4980,372,9,
.L8,4980,5119,139,8,
.L7,5119,5137,18,5,
.L4,5137,5215,78,7,
.L10,5215,5231,16,4,
.L9,5231,5466,235,8,
file_compressible,5466,5651,185,8,
.LPIC3,5651,5944,293,9,
.L12,5944,5963,19,5,
.L14,5963,6096,133,8,
.L15,6096,6163,67,7,
.L17,6163,6179,16,4,
.L16,6179,6329,150,8,
.LC35,6329,6506,177,8,
breakHandler,6506,6685,179,8,
.LPIC4,6685,6769,84,7,
.LPIC5,6769,6964,195,8,
.L20,6964,6980,16,4,
.L19,6980,7133,153,8,
.LC36,7133,7294,161,8,
clearscreen,7294,7441,147,8,
.LPIC6,7441,7552,111,7,
.LPIC7,7552,7691,139,8,
.L23,7691,7707,16,4,
.L22,7707,7858,151,8,
.LC37,7858,7971,113,7,
.LC38,7971,8073,102,7,
.LC39,8073,8112,39,6,
.LC40,8112,8227,115,7,
.LC41,8227,8234,7,3,
	.ascii	"Current time,8234,8369,135,8,
signon_msg,8369,8536,167,8,
.LPIC8,8536,8638,102,7,
.LPIC9,8638,8731,93,7,
.LPIC10,8731,8825,94,7,
.LPIC11,8825,8940,115,7,
.LPIC12,8940,9016,76,7,
.LPIC13,9016,9095,79,7,
.LPIC14,9095,9308,213,8,
.LPIC15,9308,9396,88,7,
.LPIC16,9396,9475,79,7,
.LPIC17,9475,9735,260,9,
.LPIC18,9735,9907,172,8,
.L29,9907,9918,11,4,
.L24,9918,10038,120,7,
.L28,10038,10113,75,7,
.L31,10113,10129,16,4,
.L30,10129,10634,505,9,
emit_radix_64,10634,10760,126,7,
moreflag,10760,10851,91,7,
filter_mode,10851,11173,322,9,
clear_signatures,11173,11379,206,8,
encrypt_to_self,11379,11499,120,7,
sign_new_userids,11499,11597,98,7,
batchmode,11597,11683,86,7,
quietmode,11683,11779,96,7,
force_flag,11779,11874,95,7,
literal_mode,11874,11975,101,7,
my_name,11975,12055,80,7,
keepctx,12055,12157,102,7,
interactive_add,12157,12277,120,7,
compress_enabled,12277,12385,108,7,
timeshift,12385,12497,112,7,
version_byte,12497,12588,91,7,
nomanual,12588,12686,98,7,
makerandom,12686,12914,228,8,
signature_checked,12914,13030,116,7,
checksig_pass,13030,13176,146,8,
charset_header,13176,13299,123,7,
myArgc,13299,13409,110,7,
passwds,13409,13506,97,7,
keypasswds,13506,13614,108,7,
passwdstail,13614,13670,56,6,
.LC42,13670,13709,39,6,
.LC43,13709,13750,41,6,
.LC44,13750,13793,43,6,
.LC45,13793,13836,43,6,
.LC46,13836,13880,44,6,
.LC47,13880,13922,42,6,
.LC48,13922,13990,68,7,
.LC49,13990,14025,35,6,
.LC50,14025,14083,58,6,
.LC51,14083,14117,34,6,
.LC52,14117,14124,7,3,
	.ascii	"abcdefghiklmo,14124,14198,74,7,
.LC53,14198,14232,34,6,
.LC54,14232,14265,33,6,
.LC55,14265,14328,63,6,
.LC56,14328,14335,7,3,
	.ascii	"\012\007Error,69956,70055,99,7,
.LC57,14434,14503,69,7,
.LC58,14503,14634,131,8,
	.ascii	"ducts and custom development services, contact,14634,14812,178,8,
.LC59,14812,14856,44,6,
.LC60,14856,14863,7,3,
	.ascii	"\012For a usage summary, type,14863,14930,67,7,
.LC61,14930,14967,37,6,
.LC62,14967,15028,61,6,
.LC63,15028,15107,79,7,
.LC64,15107,15114,7,3,
	.ascii	"\007Invalid filename,15114,15178,64,6,
.LC65,15178,15289,111,7,
.LC66,15289,15391,102,7,
.LC67,15391,15398,7,3,
	.ascii	"\012Note,15398,15517,119,7,
.LC68,15517,15524,7,3,
.LC69,15623,15705,82,7,
.LC70,15705,15926,221,8,
.LC71,15926,15981,55,6,
.LC72,15981,16083,102,7,
.LC73,16083,16190,107,7,
.LC74,16190,16197,7,3,
	.ascii	"\012Enter the recipient's user ID,16197,16257,60,6,
.LC75,16257,16289,32,5,
.LC76,16289,16345,56,6,
.LC77,16345,16352,7,3,
	.ascii	"\012Ciphertext file,16352,16404,52,6,
.LC78,16404,16411,7,3,
	.ascii	"\012Signature file,16411,16560,149,8,
main,16560,16783,223,8,
.LPIC19,16783,17588,805,10,
.LPIC20,17588,17952,364,9,
.LPIC21,17952,18050,98,7,
.LPIC22,18050,18128,78,7,
.L33,18128,18186,58,6,
.L43,18186,18903,717,10,
.L38,18903,19201,298,9,
.L42,19201,19315,114,7,
.L41,19315,19484,169,8,
.LPIC23,19484,19613,129,8,
.LPIC24,19613,19656,43,6,
.L194,19656,19668,12,4,
.L37,19668,19753,85,7,
.L34,19753,19851,98,7,
.L195,19851,19863,12,4,
.L40,19863,19904,41,6,
.LPIC25,19904,20293,389,9,
.L47,20293,20378,85,7,
.L45,20378,20595,217,8,
.L46,20595,21038,443,9,
.LPIC26,21038,21167,129,8,
.LPIC27,21167,21202,35,6,
.L44,21202,21270,68,7,
.LPIC28,21270,21392,122,7,
.LPIC29,21392,21514,122,7,
.LPIC30,21514,21636,122,7,
.LPIC31,21636,21703,67,7,
.LPIC32,21703,21754,51,6,
.LPIC33,21754,21841,87,7,
.LPIC34,21841,22021,180,8,
.LPIC35,22021,22142,121,7,
.L48,22142,22269,127,7,
.LPIC36,22269,22369,100,7,
.L49,22369,22432,63,6,
.LPIC37,22432,22685,253,8,
.L50,22685,23000,315,9,
.LPIC38,23000,23130,130,8,
.L51,23130,23317,187,8,
.L83,23317,23479,162,8,
.LPIC39,23479,23628,149,8,
.LPIC40,23628,23765,137,8,
.L53,23765,24124,359,9,
.LPIC41,24124,24195,71,7,
.LPIC42,24195,24747,552,10,
.L54,24747,25109,362,9,
.L58,25109,25244,135,8,
.L59,25244,25313,69,7,
.L60,25313,25711,398,9,
.L57,25711,25864,153,8,
.L63,25864,27402,1538,11,
.L65,27402,27472,70,7,
.LPIC43,27472,27913,441,9,
.L66,27913,27938,25,5,
.LPIC44,27938,28023,85,7,
.LPIC45,28023,28466,443,9,
.L67,28466,28600,134,8,
.LPIC46,28600,28977,377,9,
.L68,28977,29002,25,5,
.LPIC47,29002,29507,505,9,
.L69,29507,29950,443,9,
.L70,29950,29975,25,5,
.LPIC48,29975,30480,505,9,
.L64,30480,30957,477,9,
.L71,30957,31400,443,9,
.L72,31400,31425,25,5,
.LPIC49,31425,31930,505,9,
.L73,31930,31955,25,5,
.LPIC50,31955,32460,505,9,
.L75,32460,32485,25,5,
.LPIC51,32485,32990,505,9,
.L74,32990,33066,76,7,
.LPIC52,33066,33557,491,9,
.L76,33557,33582,25,5,
.LPIC53,33582,34087,505,9,
.L77,34087,34112,25,5,
.LPIC54,34112,34619,507,9,
.L78,34619,34722,103,7,
.LPIC55,34722,34791,69,7,
.LPIC56,34791,35296,505,9,
.L79,35296,35739,443,9,
.L80,35739,36201,462,9,
.L62,36201,36414,213,8,
.LPIC57,36414,36520,106,7,
.L82,36520,36982,462,9,
.L200,36982,36999,17,5,
.L199,36999,38341,1342,11,
.L81,38341,38435,94,7,
.L61,38435,38908,473,9,
.L52,38908,39024,116,7,
.L196,39024,39036,12,4,
.L56,39036,39109,73,7,
.LPIC58,39109,39369,260,9,
.L84,39369,39413,44,6,
.LPIC59,39413,39488,75,7,
.LPIC60,39488,39541,53,6,
.LPIC61,39541,39695,154,8,
.L85,39695,39719,24,5,
.LPIC62,39719,39774,55,6,
.L86,39774,39985,211,8,
.L87,39985,40283,298,9,
.L89,40283,40337,54,6,
.L88,40337,40361,24,5,
.LPIC63,40361,40456,95,7,
.LPIC64,40456,40551,95,7,
.LPIC65,40551,40600,49,6,
.L90,40600,40624,24,5,
.LPIC66,40624,40792,168,8,
.LPIC67,40792,40876,84,7,
.LPIC68,40876,40927,51,6,
.L91,40927,40951,24,5,
.LPIC69,40951,41026,75,7,
.LPIC70,41026,41075,49,6,
.L92,41075,41099,24,5,
.LPIC71,41099,41486,387,9,
.LPIC72,41486,41562,76,7,
.L95,41562,41922,360,9,
.LPIC73,41922,42231,309,9,
.L96,42231,42452,221,8,
.LPIC74,42452,42640,188,8,
.L98,42640,42714,74,7,
.LPIC75,42714,42894,180,8,
.L97,42894,42930,36,6,
.L94,42930,42981,51,6,
.L93,42981,43005,24,5,
.LPIC76,43005,43080,75,7,
.LPIC77,43080,43177,97,7,
.LPIC78,43177,43274,97,7,
.LPIC79,43274,43343,69,7,
.L101,43343,43419,76,7,
.LPIC80,43419,43555,136,8,
.LPIC81,43555,43652,97,7,
.LPIC82,43652,43860,208,8,
.L102,43860,43936,76,7,
.LPIC83,43936,44063,127,7,
.L99,44063,44088,25,5,
.LPIC84,44088,44272,184,8,
.L103,44272,44475,203,8,
.L104,44475,44569,94,7,
.L100,44569,44595,26,5,
.LPIC85,44595,44709,114,7,
.LPIC86,44709,44753,44,6,
.L105,44753,44779,26,5,
.LPIC87,44779,44856,77,7,
.LPIC88,44856,45157,301,9,
.LPIC89,45157,45237,80,7,
.L108,45237,45313,76,7,
.LPIC90,45313,45391,78,7,
.LPIC91,45391,45590,199,8,
.L109,45590,45616,26,5,
.LPIC92,45616,45675,59,6,
.L107,45675,45958,283,9,
.LPIC93,45958,46172,214,8,
.L111,46172,46216,44,6,
.LPIC94,46216,46430,214,8,
.L112,46430,46474,44,6,
.LPIC95,46474,46679,205,8,
.L110,46679,46842,163,8,
.LPIC96,46842,46980,138,8,
.LPIC97,46980,47060,80,7,
.L106,47060,47220,160,8,
.LPIC98,47220,47358,138,8,
.LPIC99,47358,47438,80,7,
.L113,47438,47560,122,7,
.LPIC100,47560,47680,120,7,
.L114,47680,47706,26,5,
.LPIC101,47706,47784,78,7,
.LPIC102,47784,47860,76,7,
.L116,47860,47917,57,6,
.L115,47917,47943,26,5,
.LPIC103,47943,48150,207,8,
.L117,48150,48219,69,7,
.L118,48219,48712,493,9,
.L120,48712,48825,113,7,
.L121,48825,48851,26,5,
.LPIC104,48851,48949,98,7,
.LPIC105,48949,49067,118,7,
.L122,49067,49104,37,6,
.L119,49104,49130,26,5,
.LPIC106,49130,49228,98,7,
.LPIC107,49228,49493,265,9,
.LPIC108,49493,49682,189,8,
.LPIC109,49682,49869,187,8,
.L123,49869,49895,26,5,
.LPIC110,49895,49993,98,7,
.LPIC111,49993,50214,221,8,
.L124,50214,50240,26,5,
.LPIC112,50240,50338,98,7,
.LPIC113,50338,50433,95,7,
.LPIC114,50433,50514,81,7,
.LPIC115,50514,50575,61,6,
.L125,50575,50701,126,7,
.L126,50701,50775,74,7,
.LPIC116,50775,51013,238,8,
.LPIC117,51013,51152,139,8,
.LPIC118,51152,51203,51,6,
.L127,51203,51229,26,5,
.LPIC119,51229,51327,98,7,
.LPIC120,51327,51476,149,8,
.LPIC121,51476,51596,120,7,
.LPIC122,51596,51677,81,7,
.L128,51677,51703,26,5,
.LPIC123,51703,52003,300,9,
.LPIC124,52003,52195,192,8,
.L129,52195,52215,20,5,
.L130,52215,52273,58,6,
.LPIC125,52273,52371,98,7,
.LPIC126,52371,52469,98,7,
.LPIC127,52469,52617,148,8,
.LPIC128,52617,52718,101,7,
.L132,52718,52744,26,5,
.LPIC129,52744,52842,98,7,
.LPIC130,52842,52990,148,8,
.LPIC131,52990,53091,101,7,
.L133,53091,53226,135,8,
.LPIC132,53226,53536,310,9,
.LPIC133,53536,53634,98,7,
.LPIC134,53634,53840,206,8,
.L135,53840,54034,194,8,
.L136,54034,54103,69,7,
.L134,54103,54277,174,8,
.LPIC135,54277,54430,153,8,
.L137,54430,54508,78,7,
.L138,54508,54577,69,7,
.L139,54577,54712,135,8,
.L140,54712,54741,29,5,
.L141,54741,54761,20,5,
.L142,54761,54800,39,6,
.LPIC136,54800,55086,286,9,
.LPIC137,55086,55384,298,9,
.LPIC138,55384,55504,120,7,
.LPIC139,55504,55595,91,7,
.L131,55595,55843,248,8,
.LPIC140,55843,55996,153,8,
.L145,55996,56074,78,7,
.L146,56074,56143,69,7,
.L147,56143,56169,26,5,
.LPIC141,56169,56480,311,9,
.L144,56480,56580,100,7,
.LPIC142,56580,56733,153,8,
.L149,56733,56811,78,7,
.L150,56811,56880,69,7,
.L151,56880,56980,100,7,
.LPIC143,56980,57078,98,7,
.LPIC144,57078,57226,148,8,
.LPIC145,57226,57327,101,7,
.L153,57327,57558,231,8,
.L154,57558,57634,76,7,
.LPIC146,57634,57804,170,8,
.LPIC147,57804,57952,148,8,
.LPIC148,57952,58197,245,8,
.LPIC149,58197,58328,131,8,
.L156,58328,58385,57,6,
.LPIC150,58385,58488,103,7,
.LPIC151,58488,58533,45,6,
.L155,58533,58602,69,7,
.L157,58602,58680,78,7,
.L202,58680,58697,17,5,
.L201,58697,61659,2962,12,
.L160,61659,61745,86,7,
.L158,61745,61922,177,8,
.L159,61922,62134,212,8,
.L152,62134,62311,177,8,
.L161,62311,62545,234,8,
.LPIC152,62545,62743,198,8,
.L163,62743,62764,21,5,
.L164,62764,62788,24,5,
.LPIC153,62788,62853,65,7,
.L148,62853,63080,227,8,
.LPIC154,63080,63233,153,8,
.L166,63233,63311,78,7,
.L167,63311,63380,69,7,
.L168,63380,63579,199,8,
.L165,63579,63678,99,7,
.LPIC155,63678,63963,285,9,
.LPIC156,63963,64044,81,7,
.L171,64044,64161,117,7,
.L170,64161,64280,119,7,
.LPIC157,64280,64361,81,7,
.L173,64361,64424,63,6,
.L169,64424,64449,25,5,
.LPIC158,64449,64526,77,7,
.LPIC159,64526,64629,103,7,
.L175,64629,64767,138,8,
.L184,64767,64792,25,5,
.LPIC160,64792,64956,164,8,
.LPIC161,64956,65071,115,7,
.LPIC162,65071,65151,80,7,
.L178,65151,65176,25,5,
.LPIC163,65176,65365,189,8,
.LPIC164,65365,65445,80,7,
.L179,65445,65488,43,6,
.LPIC165,65488,65559,71,7,
.L177,65559,65927,368,9,
.L182,65927,66100,173,8,
.L183,66100,66193,93,7,
.L197,66193,66214,21,5,
.L198,66214,66226,12,4,
.L181,66226,66251,25,5,
.LPIC166,66251,66553,302,9,
.LPIC167,66553,66634,81,7,
.L186,66634,66751,117,7,
.L185,66751,66867,116,7,
.LPIC168,66867,66921,54,6,
.LPIC169,66921,66998,77,7,
.LPIC170,66998,67079,81,7,
.L189,67079,67104,25,5,
.LPIC171,67104,67322,218,8,
.LPIC172,67322,67400,78,7,
.LPIC173,67400,67486,86,7,
.L190,67486,67511,25,5,
.LPIC174,67511,67655,144,8,
.LPIC175,67655,67734,79,7,
.LPIC176,67734,67811,77,7,
.L174,67811,68089,278,9,
.LPIC177,68089,68297,208,8,
.L191,68297,68479,182,8,
.L193,68479,68555,76,7,
.L204,68555,68572,17,5,
.L203,68572,69533,961,10,
initsigs,69533,69747,214,8,
.LPIC178,69747,69810,63,6,
.L207,69810,69836,26,5,
.L209,69836,69853,17,5,
.L208,69853,69949,96,7,
.LC79,69949,69956,7,3,
.LC80,70055,70153,98,7,
.LC81,70153,70319,166,8,
do_armorfile,70319,70519,200,8,
.LPIC179,70519,70697,178,8,
.L229,70697,71208,511,9,
.LPIC180,71208,71346,138,8,
.LPIC181,71346,71427,81,7,
.L211,71427,71452,25,5,
.LPIC182,71452,71549,97,7,
.LPIC183,71549,71628,79,7,
.L212,71628,71653,25,5,
.LPIC184,71653,71730,77,7,
.LPIC185,71730,71827,97,7,
.LPIC186,71827,71881,54,6,
.LPIC187,71881,72093,212,8,
.L215,72093,72118,25,5,
.LPIC188,72118,72220,102,7,
.L214,72220,72381,161,8,
.LPIC189,72381,72452,71,7,
.L217,72452,72640,188,8,
.LPIC190,72640,72721,81,7,
.L218,72721,72746,25,5,
.LPIC191,72746,72893,147,8,
.LPIC192,72893,73044,151,8,
.L219,73044,73069,25,5,
.LPIC193,73069,73234,165,8,
.L220,73234,73329,95,7,
.L213,73329,73354,25,5,
.LPIC194,73354,73451,97,7,
.LPIC195,73451,73512,61,6,
.L223,73512,73684,172,8,
.L224,73684,73756,72,7,
.LPIC196,73756,73853,97,7,
.LPIC197,73853,74365,512,9,
.L226,74365,74419,54,6,
.L225,74419,74444,25,5,
.LPIC198,74444,74514,70,7,
.L232,74514,74526,12,4,
.L222,74526,74747,221,8,
.L227,74747,74822,75,7,
.LPIC199,74822,74951,129,8,
.L233,74951,74963,12,4,
.L210,74963,75088,125,7,
.L231,75088,75160,72,7,
.L235,75160,75177,17,5,
.L234,75177,76016,839,10,
.LC82,76016,76091,75,7,
.LC83,76091,76193,102,7,
.LC84,76193,76299,106,7,
.LC85,76299,76413,114,7,
.LC86,76413,76454,41,6,
.LC87,76454,76525,71,7,
.LC88,76525,76602,77,7,
.LC89,76602,76704,102,7,
.LC90,76704,76759,55,6,
.LC91,76759,76766,7,3,
	.ascii	"\007\012ERROR,76766,76867,101,7,
.LC92,76867,76874,7,3,
	.ascii	"\007\012Error,98279,98341,62,6,
.LC93,76978,77096,118,7,
.LC94,77096,77168,72,7,
.LC95,77168,77234,66,7,
.LC96,77234,77300,66,7,
.LC97,77300,77307,7,3,
	.ascii	"Enter filename to save file as,77307,77364,57,6,
.LC98,77364,77371,7,3,
	.ascii	"[%s],77371,77402,31,5,
.LC99,77402,77409,7,3,
	.ascii	"\012Plaintext filename,77409,77460,51,6,
.LC100,77460,77564,104,7,
.LC101,77564,77642,78,7,
.LC102,77642,77842,200,8,
do_decrypt,77842,78040,198,8,
.LPIC200,78040,78265,225,8,
.L270,78265,78455,190,8,
.L237,78455,78660,205,8,
.LPIC201,78660,78798,138,8,
.LPIC202,78798,78881,83,7,
.L238,78881,78993,112,7,
.LPIC203,78993,79143,150,8,
.L242,79143,79212,69,7,
.L243,79212,79329,117,7,
.LPIC204,79329,79475,146,8,
.LPIC205,79475,79576,101,7,
.L245,79576,79769,193,8,
.LPIC206,79769,79853,84,7,
.L246,79853,79993,140,8,
.L244,79993,80110,117,7,
.LPIC207,80110,80360,250,8,
.LPIC208,80360,80506,146,8,
.LPIC209,80506,80607,101,7,
.L250,80607,80668,61,6,
.L249,80668,80693,25,5,
.LPIC210,80693,80790,97,7,
.LPIC211,80790,80916,126,7,
.LPIC212,80916,81017,101,7,
.L251,81017,81042,25,5,
.LPIC213,81042,81309,267,9,
.LPIC214,81309,81393,84,7,
.L252,81393,81559,166,8,
.LPIC215,81559,81815,256,8,
.L248,81815,81933,118,7,
.LPIC216,81933,82079,146,8,
.LPIC217,82079,82180,101,7,
.L254,82180,82378,198,8,
.LPIC218,82378,82462,84,7,
.L255,82462,82602,140,8,
.L253,82602,82892,290,9,
.LPIC219,82892,82976,84,7,
.L257,82976,83037,61,6,
.L256,83037,83230,193,8,
.L258,83230,83323,93,7,
.LPIC220,83323,83482,159,8,
.LPIC221,83482,83565,83,7,
.L260,83565,83626,61,6,
.L259,83626,83785,159,8,
.L261,83785,83857,72,7,
.LPIC222,83857,84096,239,8,
.L262,84096,84171,75,7,
.LPIC223,84171,84418,247,8,
.LPIC224,84418,84502,84,7,
.L263,84502,84528,26,5,
.LPIC225,84528,84626,98,7,
.LPIC226,84626,84727,101,7,
.L264,84727,84753,26,5,
.LPIC227,84753,84854,101,7,
.L265,84854,85041,187,8,
.L266,85041,85143,102,7,
.L267,85143,85218,75,7,
.LPIC228,85218,85427,209,8,
.L268,85427,85671,244,8,
.LPIC229,85671,85791,120,7,
.LPIC230,85791,85875,84,7,
.L269,85875,85904,29,5,
.L247,85904,85994,90,7,
.L308,85994,86006,12,4,
.L241,86006,86218,212,8,
.LPIC231,86218,86370,152,8,
.L272,86370,86478,108,7,
.L273,86478,86504,26,5,
.LPIC232,86504,86587,83,7,
.L271,86587,86667,80,7,
.LPIC233,86667,86765,98,7,
.LPIC234,86765,86912,147,8,
.LPIC235,86912,87051,139,8,
.LPIC236,87051,87134,83,7,
.L275,87134,87212,78,7,
.L274,87212,87320,108,7,
.L276,87320,87346,26,5,
.LPIC237,87346,87461,115,7,
.LPIC238,87461,87558,97,7,
.L277,87558,87601,43,6,
.LPIC239,87601,87766,165,8,
.LPIC240,87766,87886,120,7,
.LPIC241,87886,87984,98,7,
.LPIC242,87984,88131,147,8,
.L280,88131,88297,166,8,
.L279,88297,88323,26,5,
.LPIC243,88323,88470,147,8,
.LPIC244,88470,88580,110,7,
.L281,88580,88680,100,7,
.L282,88680,88782,102,7,
.LPIC245,88782,88856,74,7,
.LPIC246,88856,89101,245,8,
.LPIC247,89101,89228,127,7,
.L283,89228,89254,26,5,
.LPIC248,89254,89352,98,7,
.LPIC249,89352,89499,147,8,
.LPIC250,89499,89736,237,8,
.LPIC251,89736,90051,315,9,
.LPIC252,90051,90114,63,6,
.L285,90114,90477,363,9,
.L287,90477,90540,63,6,
.L286,90540,90626,86,7,
.L289,90626,90655,29,5,
.L284,90655,90731,76,7,
.L278,90731,90757,26,5,
.LPIC253,90757,90835,78,7,
.LPIC254,90835,90890,55,6,
.LPIC255,90890,91056,166,8,
.L291,91056,91082,26,5,
.LPIC256,91082,91137,55,6,
.LPIC257,91137,91303,166,8,
.LPIC258,91303,91359,56,6,
.LPIC259,91359,91481,122,7,
.L290,91481,91561,80,7,
.L292,91561,91587,26,5,
.LPIC260,91587,91685,98,7,
.LPIC261,91685,91877,192,8,
.LPIC262,91877,91960,83,7,
.L294,91960,92036,76,7,
.L293,92036,92062,26,5,
.LPIC263,92062,92352,290,9,
.L295,92352,92378,26,5,
.LPIC264,92378,92609,231,8,
.LPIC265,92609,92692,83,7,
.L297,92692,92721,29,5,
.L296,92721,92747,26,5,
.LPIC266,92747,92894,147,8,
.LPIC267,92894,93032,138,8,
.L298,93032,93325,293,9,
.LPIC268,93325,93499,174,8,
.LPIC269,93499,93636,137,8,
.L299,93636,93853,217,8,
.LPIC270,93853,93932,79,7,
.LPIC271,93932,94108,176,8,
.LPIC272,94108,94331,223,8,
.L301,94331,94706,375,9,
.L302,94706,94781,75,7,
.LPIC273,94781,94955,174,8,
.LPIC274,94955,95083,128,7,
.L300,95083,95184,101,7,
.L303,95184,95240,56,6,
.L304,95240,95362,122,7,
.LPIC275,95362,95445,83,7,
.L305,95445,95555,110,7,
.L306,95555,95692,137,8,
.L307,95692,95764,72,7,
.L310,95764,95781,17,5,
.L309,95781,98271,2490,12,
.LC103,98271,98279,8,3,
	.ascii	"ooked for it in the following directories,98341,98412,71,7,
.LC104,98412,98459,47,6,
.LC105,98459,99265,806,10,
.LC106,99265,99316,51,6,
.LC107,99316,99350,34,6,
.LC108,99350,99411,61,6,
.LC109,99411,99472,61,6,
.LC110,99472,99542,70,7,
.LC111,99542,99655,113,7,
.LC112,99655,99663,8,3,
	.ascii	"\012Enter the public key's user ID,99663,99724,61,6,
.LC113,99724,99732,8,3,
	.ascii	"Warning,99732,99798,66,7,
.LC114,99798,99856,58,6,
.LC115,99856,99975,119,7,
.LC116,99975,99983,8,3,
	.ascii	"\012Enter user ID,99983,100027,44,6,
.LC117,100027,100133,106,7,
.LC118,100133,100141,8,3,
	.ascii	"\012Enter the key's user ID,100141,100195,54,6,
.LC119,100195,100252,57,6,
.LC120,100252,100326,74,7,
.LC121,100326,100435,109,7,
.LC122,100435,100495,60,6,
.LC123,100495,100640,145,8,
.LC124,100640,100748,108,7,
.LC125,100748,100813,65,7,
.LC126,100813,100872,59,6,
.LC127,100872,101018,146,8,
do_keyopt,101018,101228,210,8,
.LPIC276,101228,101336,108,7,
.LPIC277,101336,101433,97,7,
.LPIC278,101433,101512,79,7,
.L312,101512,101841,329,9,
.LPIC279,101841,101920,79,7,
.L314,101920,101945,25,5,
.LPIC280,101945,102025,80,7,
.L313,102025,102050,25,5,
.LPIC281,102050,102229,179,8,
.L315,102229,102405,176,8,
.L318,102405,103159,754,10,
.L323,103159,103228,69,7,
.LPIC282,103228,103385,157,8,
.LPIC283,103385,103610,225,8,
.L330,103610,103742,132,8,
.LPIC284,103742,103872,130,8,
.L329,103872,103965,93,7,
.LPIC285,103965,104137,172,8,
.L328,104137,104162,25,5,
.LPIC286,104162,104370,208,8,
.L332,104370,104422,52,6,
.L333,104422,104447,25,5,
.LPIC287,104447,104657,210,8,
.L334,104657,104710,53,6,
.L335,104710,104735,25,5,
.LPIC288,104735,104832,97,7,
.LPIC289,104832,104946,114,7,
.LPIC290,104946,104982,36,6,
.L336,104982,105226,244,8,
.LPIC291,105226,105345,119,7,
.LPIC292,105345,105407,62,6,
.L337,105407,105454,47,6,
.L320,105454,105479,25,5,
.LPIC293,105479,105556,77,7,
.LPIC294,105556,105615,59,6,
.L339,105615,105733,118,7,
.LPIC295,105733,105802,69,7,
.LPIC296,105802,105855,53,6,
.LPIC297,105855,105959,104,7,
.LPIC298,105959,106009,50,6,
.L340,106009,106035,26,5,
.LPIC299,106035,106198,163,8,
.L341,106198,106349,151,8,
.L342,106349,106375,26,5,
.LPIC300,106375,106453,78,7,
.LPIC301,106453,106612,159,8,
.LPIC302,106612,106874,262,9,
.LPIC303,106874,106924,50,6,
.L343,106924,107010,86,7,
.LPIC304,107010,107201,191,8,
.LPIC305,107201,107321,120,7,
.LPIC306,107321,107383,62,6,
.L344,107383,107463,80,7,
.LPIC307,107463,107582,119,7,
.L345,107582,107861,279,9,
.LPIC308,107861,107981,120,7,
.LPIC309,107981,108043,62,6,
.L346,108043,108144,101,7,
.L347,108144,108173,29,5,
.L324,108173,108199,26,5,
.LPIC310,108199,108362,163,8,
.L349,108362,108508,146,8,
.L350,108508,108638,130,8,
.LPIC311,108638,108711,73,7,
.L351,108711,108737,26,5,
.LPIC312,108737,108838,101,7,
.L352,108838,108858,20,5,
.L353,108858,109136,278,9,
.LPIC313,109136,109255,119,7,
.L355,109255,109331,76,7,
.LPIC314,109331,109451,120,7,
.LPIC315,109451,109513,62,6,
.L354,109513,109560,47,6,
.L326,109560,109586,26,5,
.LPIC316,109586,109797,211,8,
.L356,109797,109898,101,7,
.L357,109898,109924,26,5,
.LPIC317,109924,110095,171,8,
.LPIC318,110095,110154,59,6,
.L358,110154,110230,76,7,
.LPIC319,110230,110350,120,7,
.LPIC320,110350,110451,101,7,
.L360,110451,110527,76,7,
.LPIC321,110527,110675,148,8,
.LPIC322,110675,110728,53,6,
.L359,110728,110754,26,5,
.LPIC323,110754,110902,148,8,
.LPIC324,110902,111072,170,8,
.LPIC325,111072,111173,101,7,
.L361,111173,111245,72,7,
.LPIC326,111245,111298,53,6,
.LPIC327,111298,111652,354,9,
.LPIC328,111652,111725,73,7,
.L363,111725,111855,130,8,
.LPIC329,111855,111956,101,7,
.L362,111956,112086,130,8,
.LPIC330,112086,112206,120,7,
.LPIC331,112206,112268,62,6,
.L364,112268,112315,47,6,
.L321,112315,112341,26,5,
.LPIC332,112341,112552,211,8,
.L365,112552,112653,101,7,
.L366,112653,112679,26,5,
.LPIC333,112679,112850,171,8,
.LPIC334,112850,112909,59,6,
.L367,112909,112985,76,7,
.LPIC335,112985,113155,170,8,
.LPIC336,113155,113303,148,8,
.LPIC337,113303,113356,53,6,
.L368,113356,113428,72,7,
.LPIC338,113428,113786,358,9,
.LPIC339,113786,113859,73,7,
.L370,113859,113989,130,8,
.LPIC340,113989,114090,101,7,
.L369,114090,114170,80,7,
.LPIC341,114170,114232,62,6,
.L371,114232,114279,47,6,
.L322,114279,114305,26,5,
.LPIC342,114305,114517,212,8,
.L372,114517,114619,102,7,
.L373,114619,114645,26,5,
.LPIC343,114645,114816,171,8,
.LPIC344,114816,114875,59,6,
.L374,114875,114951,76,7,
.LPIC345,114951,115121,170,8,
.LPIC346,115121,115269,148,8,
.LPIC347,115269,115322,53,6,
.L375,115322,115395,73,7,
.LPIC348,115395,115710,315,9,
.L377,115710,115840,130,8,
.LPIC349,115840,115941,101,7,
.L376,115941,116071,130,8,
.LPIC350,116071,116191,120,7,
.LPIC351,116191,116253,62,6,
.L378,116253,116300,47,6,
.L319,116300,116326,26,5,
.LPIC352,116326,116404,78,7,
.LPIC353,116404,116502,98,7,
.L379,116502,116528,26,5,
.LPIC354,116528,116870,342,9,
.LPIC355,116870,116943,73,7,
.L381,116943,117104,161,8,
.LPIC356,117104,117241,137,8,
.LPIC357,117241,117325,84,7,
.L382,117325,117389,64,6,
.L380,117389,117515,126,7,
.L383,117515,117541,26,5,
.LPIC358,117541,117642,101,7,
.L384,117642,117662,20,5,
.L385,117662,117688,26,5,
.LPIC359,117688,118023,335,9,
.L387,118023,118134,111,7,
.L386,118134,118210,76,7,
.LPIC360,118210,118311,101,7,
.L390,118311,118332,21,5,
.L391,118332,118468,136,8,
.LPIC361,118468,118541,73,7,
.L389,118541,118682,141,8,
.LPIC362,118682,118808,126,7,
.L392,118808,118938,130,8,
.LPIC363,118938,119058,120,7,
.LPIC364,119058,119120,62,6,
.L393,119120,119167,47,6,
.L327,119167,119193,26,5,
.LPIC365,119193,119294,101,7,
.L394,119294,119314,20,5,
.L395,119314,119340,26,5,
.LPIC366,119340,119468,128,7,
.LPIC367,119468,119570,102,7,
.L397,119570,119591,21,5,
.L398,119591,119699,108,7,
.L396,119699,119801,102,7,
.L399,119801,119827,26,5,
.LPIC368,119827,119928,101,7,
.L400,119928,119948,20,5,
.L401,119948,119974,26,5,
.LPIC369,119974,120249,275,9,
.LPIC370,120249,120308,59,6,
.L403,120308,120334,26,5,
.LPIC371,120334,120393,59,6,
.L402,120393,120469,76,7,
.LPIC372,120469,120589,120,7,
.LPIC373,120589,120690,101,7,
.L406,120690,120766,76,7,
.LPIC374,120766,120914,148,8,
.LPIC375,120914,120967,53,6,
.L405,120967,120993,26,5,
.LPIC376,120993,121091,98,7,
.LPIC377,121091,121302,211,8,
.L408,121302,121354,52,6,
.L409,121354,121418,64,6,
.L407,121418,121487,69,7,
.L410,121487,121531,44,6,
.LPIC378,121531,121623,92,7,
.LPIC379,121623,121721,98,7,
.LPIC380,121721,121786,65,7,
.L439,121786,121803,17,5,
.L438,121803,125006,3203,12,
.L411,125006,125026,20,5,
.L412,125026,125114,88,7,
.LPIC381,125114,125300,186,8,
.LPIC382,125300,125419,119,7,
.LPIC383,125419,125499,80,7,
.LPIC384,125499,125625,126,7,
.L414,125625,125672,47,6,
.L413,125672,125697,25,5,
.LPIC385,125697,125848,151,8,
.LPIC386,125848,126097,249,8,
.LPIC387,126097,126180,83,7,
.L416,126180,126299,119,7,
.LPIC388,126299,126382,83,7,
.L417,126382,126436,54,6,
.L415,126436,126465,29,5,
.L325,126465,126490,25,5,
.LPIC389,126490,126698,208,8,
.L418,126698,126799,101,7,
.L419,126799,126824,25,5,
.LPIC390,126824,126994,170,8,
.LPIC391,126994,127053,59,6,
.L420,127053,127078,25,5,
.LPIC392,127078,127224,146,8,
.LPIC393,127224,127334,110,7,
.L422,127334,127408,74,7,
.LPIC394,127408,127509,101,7,
.L423,127509,127534,25,5,
.LPIC395,127534,127635,101,7,
.L424,127635,127709,74,7,
.LPIC396,127709,127856,147,8,
.LPIC397,127856,127909,53,6,
.L421,127909,128038,129,8,
.LPIC398,128038,128111,73,7,
.L425,128111,128136,25,5,
.LPIC399,128136,128263,127,7,
.LPIC400,128263,128420,157,8,
.LPIC401,128420,128539,119,7,
.LPIC402,128539,128623,84,7,
.L426,128623,128649,26,5,
.LPIC403,128649,128783,134,8,
.LPIC404,128783,128950,167,8,
.LPIC405,128950,129070,120,7,
.LPIC406,129070,129154,84,7,
.L427,129154,129183,29,5,
.L317,129183,129209,26,5,
.LPIC407,129209,129371,162,8,
.L428,129371,129518,147,8,
.L429,129518,129544,26,5,
.LPIC408,129544,129715,171,8,
.LPIC409,129715,129784,69,7,
.LPIC410,129784,129837,53,6,
.LPIC411,129837,129941,104,7,
.LPIC412,129941,130000,59,6,
.L430,130000,130026,26,5,
.LPIC413,130026,130076,50,6,
.L432,130076,130102,26,5,
.LPIC414,130102,130261,159,8,
.LPIC415,130261,130523,262,9,
.LPIC416,130523,130573,50,6,
.L433,130573,130703,130,8,
.LPIC417,130703,130776,73,7,
.L434,130776,130927,151,8,
.LPIC418,130927,131037,110,7,
.LPIC419,131037,131217,180,8,
.LPIC420,131217,131337,120,7,
.LPIC421,131337,131399,62,6,
.L435,131399,131446,47,6,
.L316,131446,131485,39,6,
.L436,131485,131624,139,8,
.L437,131624,131696,72,7,
.L441,131696,131713,17,5,
.L440,131713,133064,1351,11,
.LC128,133064,133275,211,8,
user_error,133275,133422,147,8,
.LPIC422,133422,133510,88,7,
.LPIC423,133510,133678,168,8,
.LPIC424,133678,133797,119,7,
.LPIC425,133797,133874,77,7,
.LPIC426,133874,133919,45,6,
.L443,133919,133941,22,5,
.L444,133941,134004,63,6,
.L446,134004,134021,17,5,
.L445,134021,134260,239,8,
.LC129,134260,134268,8,3,
	.ascii	"exitPGP,134268,134423,155,8,
exitPGP,134423,134647,224,8,
.LPIC427,134647,134785,138,8,
.LPIC428,134785,134981,196,8,
.LPIC429,134981,135032,51,6,
.L448,135032,135091,59,6,
.LPIC430,135091,135150,59,6,
.L450,135150,135387,237,8,
.L449,135387,135517,130,8,
.LPIC431,135517,135576,59,6,
.L452,135576,135813,237,8,
.L451,135813,136020,207,8,
.L453,136020,136180,160,8,
.L456,136180,136197,17,5,
.L455,136197,136463,266,9,
.LC130,136463,136611,148,8,
arg_error,136611,136757,146,8,
.LPIC432,136757,136865,108,7,
.LPIC433,136865,136984,119,7,
.LPIC434,136984,137092,108,7,
.L459,137092,137109,17,5,
.L458,137109,137291,182,8,
.LC131,137291,137326,35,6,
.LC132,137326,137456,130,8,
build_helpfile,137456,137652,196,8,
.LPIC436,137652,137691,39,6,
.LPIC435,137691,137977,286,9,
.LPIC437,137977,138128,151,8,
.L461,138128,138153,25,5,
.LPIC438,138153,138294,141,8,
.LPIC439,138294,138380,86,7,
.L463,138380,138392,12,4,
.L460,138392,138460,68,7,
.L465,138460,138477,17,5,
.L464,138477,138737,260,9,
.LC133,138737,138745,8,3,
	.ascii	"\012Usage summary,138745,138807,62,6,
	.ascii	"ith recipent's public key, type,138807,138993,186,8,
	.ascii	"y,138993,139179,186,8,
	.ascii	"ith recipent's public key, producing a .pgp file,139179,139367,188,8,
	.ascii	"tion only,139367,139429,62,6,
	.ascii	"heck a signature for a ciphertext (.pgp) file,139429,139677,248,8,
	.ascii	"c/secret key pair,139677,139739,62,6,
	.ascii	"y management functions, type,139739,139891,152,8,
usage,139891,140053,162,8,
.LPIC440,140053,140241,188,8,
.LPIC441,140241,140718,477,9,
.L468,140718,140800,82,7,
.L467,140800,140968,168,8,
.LPIC442,140968,141069,101,7,
.L469,141069,141191,122,7,
.L470,141191,141225,34,6,
.L473,141225,141242,17,5,
.L472,141242,141488,246,8,
.LC134,141488,141524,36,6,
.LC135,141524,141532,8,3,
	.ascii	"\012Key management functions,141532,141594,62,6,
	.ascii	"wn unique public/secret key pair,141594,141718,124,7,
	.ascii	"et key ring,141718,141842,124,7,
	.ascii	"t key ring,141842,141904,62,6,
	.ascii	"it your user ID or pass phrase,141904,142028,124,7,
	.ascii	"ur public or secret key ring,142028,142152,124,7,
	.ascii	"ublic key ring,142152,142214,62,6,
	.ascii	"\012To check signatures on your public key ring,142214,142339,125,7,
	.ascii	"se's public key on your public key ring,142339,142463,124,7,
	.ascii	"ove selected signatures from a userid on a keyring,142463,142675,212,8,
key_usage,142675,142841,166,8,
.LPIC443,142841,143029,188,8,
.LPIC444,143029,143506,477,9,
.L476,143506,143588,82,7,
.L475,143588,143756,168,8,
.LPIC445,143756,143857,101,7,
.L477,143857,143979,122,7,
.L478,143979,144013,34,6,
.L481,144013,144030,17,5,
.L480,144030,144285,255,8,
.LC136,144285,144345,60,6,
.LC137,144345,144379,34,6,
.LC138,144379,144535,156,8,
ParseRecipients,144535,144738,203,8,
.LPIC446,144738,144946,208,8,
.L486,144946,145028,82,7,
.LPIC447,145028,145193,165,8,
.L483,145193,145277,84,7,
.L507,145277,145289,12,4,
.L485,145289,145404,115,7,
.L487,145404,145674,270,9,
.L489,145674,145734,60,6,
.L504,145734,145817,83,7,
.LPIC448,145817,146547,730,10,
.L491,146547,146826,279,9,
.L493,146826,146926,100,7,
.L494,146926,147001,75,7,
.LPIC449,147001,147173,172,8,
.LPIC450,147173,147322,149,8,
.LPIC451,147322,147411,89,7,
.L502,147411,147635,224,8,
.L497,147635,147835,200,8,
.L500,147835,147921,86,7,
.L499,147921,148546,625,10,
.L501,148546,149061,515,10,
.L496,149061,149281,220,8,
.LPIC452,149281,149361,80,7,
.L503,149361,149494,133,8,
.L490,149494,149891,397,9,
.L505,149891,150049,158,8,
.L488,150049,150186,137,8,
.L506,150186,150258,72,7,
.L509,150258,150275,17,5,
.L508,150275,150282,345,9,
end,end,end,end,


LineNum,inLabel,command,JumpToLabel,jumpToAd,start_row_counter,
Label,StartPoint,EndPoint,Size,log_2,
empty,1,382,381,9,
compare,382,813,431,9,
.L9,813,932,119,7,
.L5,932,950,18,5,
.L7,950,1085,135,8,
.LC0,1085,1091,6,3,
	.ascii	"Usage,1091,1145,54,6,
.LC1,1145,1177,32,5,
.LC2,1177,1210,33,6,
.LC3,1210,1317,107,7,
.LC4,1317,1458,141,8,
main,1458,1900,442,9,
.LPIC0,1900,2370,470,9,
.LPIC1,2370,2433,63,6,
.L11,2433,2688,255,8,
.LPIC2,2688,2769,81,7,
.L14,2769,5091,2322,12,
.L12,5091,5262,171,8,
.LPIC3,5262,5560,298,9,
.LPIC4,5560,5857,297,9,
.LPIC5,5857,6096,239,8,
.L13,6096,6226,130,8,
.LPIC6,6226,6491,265,9,
.LPIC7,6491,6669,178,8,
.L16,6669,7533,864,10,
.LPIC8,7533,7802,269,9,
.L15,7802,8226,424,9,
.L18,8226,8353,127,7,
.L20,8353,8369,16,4,
.L19,8369,8375,302,9,
end,end,end,end,


LineNum,inLabel,command,JumpToLabel,jumpToAd,start_row_counter,
Label,StartPoint,EndPoint,Size,log_2,
empty,1,363,362,9,
sha_transform,363,559,196,8,
.LPIC0,559,697,138,8,
.L3,697,981,284,9,
.L2,981,1089,108,7,
.L5,1089,1653,564,10,
.L4,1653,2158,505,9,
.L7,2158,3035,877,10,
.L6,3035,3143,108,7,
.L9,3143,3959,816,10,
.L8,3959,4068,109,7,
.L11,4068,4981,913,10,
.L10,4981,5092,111,7,
.L13,5092,5909,817,10,
.L12,5909,6810,901,10,
.L14,6810,6877,67,7,
.L16,6877,6893,16,4,
.L15,6893,7102,209,8,
byte_reverse,7102,7292,190,8,
.LPIC1,7292,7500,208,8,
.L19,7500,8261,761,10,
.L18,8261,8441,180,8,
.L20,8441,8504,63,6,
.L22,8504,8520,16,4,
.L21,8520,8741,221,8,
sha_init,8741,9583,842,10,
sha_update,9583,10022,439,9,
.L25,10022,10291,269,9,
.L27,10291,10629,338,9,
.L26,10629,10982,353,9,
sha_final,10982,11875,893,10,
.L29,11875,12029,154,8,
.L30,12029,12477,448,9,
sha_stream,12477,12756,279,9,
.LPIC2,12756,12949,193,8,
.L33,12949,13106,157,8,
.L32,13106,13587,481,9,
.L34,13587,13673,86,7,
.L36,13673,13689,16,4,
.L35,13689,13825,136,8,
.LC0,13825,13997,172,8,
sha_print,13997,14407,410,9,
.LPIC3,14407,14509,102,7,
.L39,14509,14525,16,4,
.L38,14525,14531,59,6,
end,end,end,end,


LineNum,inLabel,command,JumpToLabel,jumpToAd,start_row_counter,
Label,StartPoint,EndPoint,Size,log_2,
empty,1,297,296,9,
.LC0,297,303,6,3,
	.ascii	"Usage,303,373,70,7,
.LC1,373,379,6,3,
	.ascii	"-s ,379,433,54,6,
.LC2,433,439,6,3,
	.ascii	"-e ,439,479,40,6,
.LC3,479,485,6,3,
	.ascii	"-c ,485,531,46,6,
.LC4,531,638,107,7,
.LC5,638,644,6,3,
	.ascii	"-t <thresh> ,644,738,94,7,
.LC6,738,744,6,3,
	.ascii	"-d <thresh> ,744,896,152,8,
.LC7,896,902,6,3,
	.ascii	"-3 ,902,974,72,7,
.LC8,974,980,6,3,
	.ascii	"-n ,980,1093,113,7,
.LC9,1093,1099,6,3,
	.ascii	"-q ,1099,1255,156,8,
.LC10,1255,1262,7,3,
	.ascii	"-b ,1262,1415,153,8,
.LC11,1415,1422,7,3,
	.ascii	"-p ,1422,1547,125,7,
.LC12,1547,1768,221,8,
usage,1768,1900,132,8,
.LPIC0,1900,1961,61,6,
.LPIC1,1961,2022,61,6,
.LPIC2,2022,2084,62,6,
.LPIC3,2084,2146,62,6,
.LPIC4,2146,2208,62,6,
.LPIC5,2208,2270,62,6,
.LPIC6,2270,2332,62,6,
.LPIC7,2332,2394,62,6,
.LPIC8,2394,2456,62,6,
.LPIC9,2456,2518,62,6,
.LPIC10,2518,2581,63,6,
.LPIC11,2581,2644,63,6,
.LPIC12,2644,2718,74,7,
.L3,2718,2733,15,4,
.L2,2733,3093,360,9,
.LC13,3093,3127,34,6,
.LC14,3127,3289,162,8,
getint,3289,3520,231,8,
.LPIC13,3520,3755,235,8,
.L9,3755,3946,191,8,
.L5,3946,4087,141,8,
.LPIC14,4087,4125,38,6,
.LPIC15,4125,4202,77,7,
.L6,4202,4350,148,8,
.L7,4350,4478,128,7,
.L17,4478,4551,73,7,
.L13,4551,5012,461,9,
.L10,5012,5170,158,8,
.L12,5170,5225,55,6,
.L14,5225,5389,164,8,
.L15,5389,5479,90,7,
.L19,5479,5495,16,4,
.L18,5495,5693,198,8,
.LC15,5693,5726,33,6,
.LC16,5726,5783,57,6,
.LC17,5783,5860,77,7,
.LC18,5860,6027,167,8,
get_image,6027,6257,230,8,
.LPIC16,6257,6362,105,7,
.LPIC17,6362,6574,212,8,
.LPIC18,6574,6651,77,7,
.L21,6651,6939,288,9,
.L22,6939,7030,91,7,
.LPIC19,7030,7107,77,7,
.L23,7107,7767,660,10,
.LPIC20,7767,7844,77,7,
.L24,7844,8006,162,8,
.L25,8006,8074,68,7,
.L27,8074,8090,16,4,
.L26,8090,8344,254,8,
.LC19,8344,8377,33,6,
.LC20,8377,8434,57,6,
.LC21,8434,8472,38,6,
.LC22,8472,8513,41,6,
.LC23,8513,8552,39,6,
.LC24,8552,8717,165,8,
put_image,8717,8945,228,8,
.LPIC22,8945,8982,37,6,
.LPIC21,8982,9193,211,8,
.LPIC23,9193,9270,77,7,
.L29,9270,9338,68,7,
.LPIC24,9338,9424,86,7,
.LPIC25,9424,9543,119,7,
.LPIC26,9543,9824,281,9,
.LPIC27,9824,9901,77,7,
.L30,9901,10020,119,7,
.L32,10020,10036,16,4,
.L31,10036,10421,385,9,
int_to_uchar,10421,10764,343,9,
.L37,10764,11000,236,8,
.L35,11000,11236,236,8,
.L36,11236,11297,61,6,
.L34,11297,11476,179,8,
.L39,11476,11862,386,9,
.L38,11862,12170,308,9,
setup_brightness_lut,12170,12589,419,9,
.L43,12589,13046,457,9,
.L42,13046,13486,440,9,
.L41,13486,13597,111,7,
.L45,13597,13613,16,4,
.L44,13613,13821,208,8,
susan_principle,13821,14207,386,9,
.L51,14207,14253,46,6,
.L50,14253,23815,9562,14,
.L49,23815,23876,61,6,
.L48,23876,24014,138,8,
.L47,24014,24348,334,9,
susan_principle_small,24348,24769,421,9,
.L57,24769,24815,46,6,
.L56,24815,27525,2710,12,
.L55,27525,27586,61,6,
.L54,27586,27724,138,8,
.L53,27724,28040,316,9,
median,28040,28261,221,8,
.LPIC28,28261,29977,1716,11,
.L63,29977,30023,46,6,
.L62,30023,30674,651,10,
.L61,30674,30735,61,6,
.L60,30735,30872,137,8,
.L59,30872,31164,292,9,
.L65,31164,31227,63,6,
.L67,31227,31243,16,4,
.L66,31243,31451,208,8,
enlarge,31451,31699,248,8,
.L70,31699,32173,474,9,
.L69,32173,32288,115,7,
.L72,32288,33299,1011,10,
.L71,33299,33405,106,7,
.L76,33405,33451,46,6,
.L75,33451,34682,1231,11,
.L74,34682,34864,182,8,
.L73,34864,35333,469,9,
.LC25,35333,35432,99,7,
.LC26,35432,35536,104,7,
.LC27,35536,35543,7,3,
	.ascii	"as a float,35543,35608,65,7,
.LC28,35608,35838,230,8,
susan_smoothing,35838,36381,543,10,
.L78,36381,36419,38,6,
.L79,36419,36676,257,9,
.LPIC29,36676,36743,67,7,
.LPIC30,36743,36808,65,7,
.LPIC31,36808,36882,74,7,
.L80,36882,37075,193,8,
.L82,37075,37155,80,7,
.LPIC32,37155,37219,64,6,
.L83,37219,38084,865,10,
.L88,38084,38149,65,7,
.L87,38149,38698,549,10,
.L86,38698,38819,121,7,
.L85,38819,38931,112,7,
.L98,38931,38983,52,6,
.L97,38983,39628,645,10,
.L94,39628,39693,65,7,
.L93,39693,40280,587,10,
.L92,40280,40474,194,8,
.L91,40474,40850,376,9,
.L95,40850,41119,269,9,
.L96,41119,41180,61,6,
.L90,41180,41337,157,8,
.L89,41337,41447,110,7,
.L84,41447,41494,47,6,
.L105,41494,41542,48,6,
.L109,41542,41559,17,5,
.L108,41559,41693,134,8,
.L104,41693,46251,4558,13,
.L102,46251,46501,250,8,
.L103,46501,46563,62,6,
.L101,46563,46703,140,8,
.L100,46703,46787,84,7,
.L107,46787,47014,227,8,
edge_draw,47014,47374,360,9,
.L114,47374,48434,1060,11,
.L113,48434,48551,117,7,
.L112,48551,48648,97,7,
.L111,48648,48733,85,7,
.L117,48733,48945,212,8,
.L116,48945,49062,117,7,
.L115,49062,49387,325,9,
susan_thin,49387,49621,234,8,
.LPIC33,49621,49753,132,8,
.L154,49753,49801,48,6,
.L153,49801,51926,2125,12,
.L122,51926,54532,2606,12,
.L124,54532,55196,664,10,
.L126,55196,55865,669,10,
.L127,55865,56517,652,10,
.L128,56517,57169,652,10,
.L129,57169,57838,669,10,
.L130,57838,58502,664,10,
.L131,58502,59162,660,10,
.L125,59162,59242,80,7,
.L136,59242,59290,48,6,
.L135,59290,59774,484,9,
.L134,59774,59836,62,6,
.L133,59836,59940,104,7,
.L132,59940,60485,545,10,
.L137,60485,60931,446,9,
.L138,60931,61286,355,9,
.L139,61286,61367,81,7,
.L123,61367,62950,1583,11,
.L143,62950,63030,80,7,
.L142,63030,63152,122,7,
.L146,63152,63223,71,7,
.L145,63223,64457,1234,11,
.L149,64457,65269,812,10,
.L150,65269,65681,412,9,
.L159,65681,65698,17,5,
.L158,65698,65812,114,7,
.L141,65812,69894,4082,12,
.L151,69894,69984,90,7,
.L157,69984,69996,12,4,
.L140,69996,73387,3391,12,
.L152,73387,73468,81,7,
.L121,73468,73530,62,6,
.L120,73530,73669,139,8,
.L119,73669,73882,213,8,
.L155,73882,73951,69,7,
.L161,73951,73968,17,5,
.L160,73968,74152,184,8,
susan_edges,74152,74536,384,9,
.L167,74536,74584,48,6,
.L166,74584,84154,9570,14,
.L165,84154,84216,62,6,
.L164,84216,84356,140,8,
.L163,84356,84482,126,7,
.L197,84482,84530,48,6,
.L196,84530,99124,14594,14,
.L174,99124,99303,179,8,
.L175,99303,99495,192,8,
.L205,99495,99534,39,6,
.L178,99534,99715,181,8,
.L206,99715,99896,181,8,
.L207,99896,100018,122,7,
.L184,100018,100089,71,7,
.L181,100089,101404,1315,11,
.L204,101404,101452,48,6,
.L211,101452,101469,17,5,
.L210,101469,101512,43,6,
.L171,101512,101551,39,6,
.L187,101551,117761,16210,14,
.L188,117761,117940,179,8,
.L189,117940,118121,181,8,
.L208,118121,118302,181,8,
.L209,118302,118424,122,7,
.L195,118424,118495,71,7,
.L192,118495,119801,1306,11,
.L170,119801,119863,62,6,
.L169,119863,120003,140,8,
.L168,120003,120323,320,9,
susan_edges_small,120323,120747,424,9,
.L217,120747,120795,48,6,
.L216,120795,123513,2718,12,
.L215,123513,123575,62,6,
.L214,123575,123715,140,8,
.L213,123715,123841,126,7,
.L247,123841,123889,48,6,
.L246,123889,128083,4194,13,
.L224,128083,128262,179,8,
.L225,128262,128454,192,8,
.L255,128454,128493,39,6,
.L228,128493,128674,181,8,
.L256,128674,128855,181,8,
.L257,128855,128977,122,7,
.L234,128977,129048,71,7,
.L231,129048,129761,713,10,
.L254,129761,129809,48,6,
.L221,129809,129848,39,6,
.L237,129848,133248,3400,12,
.L238,133248,133427,179,8,
.L239,133427,133608,181,8,
.L261,133608,133625,17,5,
.L260,133625,133668,43,6,
.L258,133668,133849,181,8,
.L259,133849,133971,122,7,
.L245,133971,134042,71,7,
.L242,134042,134746,704,10,
.L220,134746,134808,62,6,
.L219,134808,134948,140,8,
.L218,134948,135268,320,9,
corner_draw,135268,135551,283,9,
.L265,135551,136840,1289,11,
.L264,136840,137263,423,9,
.L263,137263,137541,278,9,
.LC29,137541,137710,169,8,
susan_corners,137710,137948,238,8,
.LPIC34,137948,138400,452,9,
.L291,138400,138448,48,6,
.L290,138448,163043,24595,15,
.L310,163043,163060,17,5,
.L309,163060,163108,48,6,
.L303,163108,163226,118,7,
.L273,163226,163825,599,10,
.L304,163825,163967,142,8,
.L276,163967,164633,666,10,
.L305,164633,164798,165,8,
.L279,164798,165230,432,9,
.L270,165230,165907,677,10,
.L306,165907,166025,118,7,
.L283,166025,166641,616,10,
.L307,166641,166783,142,8,
.L286,166783,167477,694,10,
.L308,167477,167642,165,8,
.L289,167642,167895,253,8,
.L280,167895,168666,771,10,
.L269,168666,168728,62,6,
.L268,168728,168868,140,8,
.L267,168868,169026,158,8,
.L296,169026,169074,48,6,
.L295,169074,182016,12942,14,
.LPIC35,182016,182080,64,6,
.L294,182080,182142,62,6,
.L293,182142,182282,140,8,
.L292,182282,182630,348,9,
.L312,182630,182647,17,5,
.L311,182647,182867,220,8,
susan_corners_quick,182867,183111,244,8,
.LPIC36,183111,183303,192,8,
.L318,183303,183351,48,6,
.L317,183351,193923,10572,14,
.L316,193923,193985,62,6,
.L315,193985,194125,140,8,
.L314,194125,194283,158,8,
.L323,194283,194331,48,6,
.L325,194331,194348,17,5,
.L324,194348,194396,48,6,
.L322,194396,220848,26452,15,
.LPIC37,220848,220912,64,6,
.L321,220912,220974,62,6,
.L320,220974,221114,140,8,
.L319,221114,221396,282,9,
.L327,221396,221413,17,5,
.L326,221413,221542,129,8,
.LC30,221542,221598,56,6,
.LC31,221598,221752,154,8,
main,221752,222049,297,9,
.LPIC38,222049,223009,960,10,
.L329,223009,223243,234,8,
.L349,223243,223888,645,10,
.L334,223888,225293,1405,11,
.L342,225293,225375,82,7,
.L338,225375,225457,82,7,
.L336,225457,225539,82,7,
.L340,225539,225620,81,7,
.L339,225620,225702,82,7,
.L335,225702,225784,82,7,
.L333,225784,225865,81,7,
.L341,225865,225946,81,7,
.L337,225946,226219,273,9,
.LPIC39,226219,226293,74,7,
.L344,226293,226694,401,9,
.L368,226694,226775,81,7,
.L343,226775,227049,274,9,
.LPIC40,227049,227123,74,7,
.L347,227123,227374,251,8,
.L331,227374,227396,22,5,
.L348,227396,227524,128,7,
.L330,227524,227876,352,9,
.L350,227876,228558,682,10,
.L352,228558,229490,932,10,
.L356,229490,229893,403,9,
.L357,229893,230157,264,9,
.L355,230157,231148,991,10,
.L359,231148,231618,470,9,
.L360,231618,231931,313,9,
.L361,231931,232256,325,9,
.L353,232256,233354,1098,11,
.L362,233354,233901,547,10,
.L364,233901,234358,457,9,
.L365,234358,234584,226,8,
.L369,234584,234596,12,4,
.L351,234596,235041,445,9,
.L367,235041,235140,99,7,
.L371,235140,235157,17,5,
.L370,235157,235164,148,8,
end,end,end,end,


LineNum,inLabel,command,JumpToLabel,jumpToAd,start_row_counter,
Label,StartPoint,EndPoint,Size,log_2,
empty,1,363,362,9,
sha_transform,363,559,196,8,
.LPIC0,559,697,138,8,
.L3,697,981,284,9,
.L2,981,1089,108,7,
.L5,1089,1653,564,10,
.L4,1653,2158,505,9,
.L7,2158,3035,877,10,
.L6,3035,3143,108,7,
.L9,3143,3959,816,10,
.L8,3959,4068,109,7,
.L11,4068,4981,913,10,
.L10,4981,5092,111,7,
.L13,5092,5909,817,10,
.L12,5909,6810,901,10,
.L14,6810,6877,67,7,
.L16,6877,6893,16,4,
.L15,6893,7102,209,8,
byte_reverse,7102,7292,190,8,
.LPIC1,7292,7500,208,8,
.L19,7500,8261,761,10,
.L18,8261,8441,180,8,
.L20,8441,8504,63,6,
.L22,8504,8520,16,4,
.L21,8520,8741,221,8,
sha_init,8741,9583,842,10,
sha_update,9583,10022,439,9,
.L25,10022,10291,269,9,
.L27,10291,10629,338,9,
.L26,10629,10982,353,9,
sha_final,10982,11875,893,10,
.L29,11875,12029,154,8,
.L30,12029,12477,448,9,
sha_stream,12477,12756,279,9,
.LPIC2,12756,12949,193,8,
.L33,12949,13106,157,8,
.L32,13106,13587,481,9,
.L34,13587,13673,86,7,
.L36,13673,13689,16,4,
.L35,13689,13825,136,8,
.LC0,13825,13997,172,8,
sha_print,13997,14407,410,9,
.LPIC3,14407,14509,102,7,
.L39,14509,14525,16,4,
.L38,14525,14531,59,6,
end,end,end,end,


LineNum,inLabel,command,JumpToLabel,jumpToAd,start_row_counter,
Label,StartPoint,EndPoint,Size,log_2,
empty,1,363,362,9,
sha_transform,363,559,196,8,
.LPIC0,559,697,138,8,
.L3,697,981,284,9,
.L2,981,1089,108,7,
.L5,1089,1653,564,10,
.L4,1653,2158,505,9,
.L7,2158,3035,877,10,
.L6,3035,3143,108,7,
.L9,3143,3959,816,10,
.L8,3959,4068,109,7,
.L11,4068,4981,913,10,
.L10,4981,5092,111,7,
.L13,5092,5909,817,10,
.L12,5909,6810,901,10,
.L14,6810,6877,67,7,
.L16,6877,6893,16,4,
.L15,6893,7102,209,8,
byte_reverse,7102,7292,190,8,
.LPIC1,7292,7500,208,8,
.L19,7500,8261,761,10,
.L18,8261,8441,180,8,
.L20,8441,8504,63,6,
.L22,8504,8520,16,4,
.L21,8520,8741,221,8,
sha_init,8741,9583,842,10,
sha_update,9583,10022,439,9,
.L25,10022,10291,269,9,
.L27,10291,10629,338,9,
.L26,10629,10982,353,9,
sha_final,10982,11875,893,10,
.L29,11875,12029,154,8,
.L30,12029,12477,448,9,
sha_stream,12477,12756,279,9,
.LPIC2,12756,12949,193,8,
.L33,12949,13106,157,8,
.L32,13106,13587,481,9,
.L34,13587,13673,86,7,
.L36,13673,13689,16,4,
.L35,13689,13825,136,8,
.LC0,13825,13997,172,8,
sha_print,13997,14407,410,9,
.LPIC3,14407,14509,102,7,
.L39,14509,14525,16,4,
.L38,14525,14531,59,6,
end,end,end,end,


LineNum,inLabel,command,JumpToLabel,jumpToAd,start_row_counter,
Label,StartPoint,EndPoint,Size,log_2,
empty,1,363,362,9,
sha_transform,363,559,196,8,
.LPIC0,559,697,138,8,
.L3,697,981,284,9,
.L2,981,1089,108,7,
.L5,1089,1653,564,10,
.L4,1653,2158,505,9,
.L7,2158,3035,877,10,
.L6,3035,3143,108,7,
.L9,3143,3959,816,10,
.L8,3959,4068,109,7,
.L11,4068,4981,913,10,
.L10,4981,5092,111,7,
.L13,5092,5909,817,10,
.L12,5909,6810,901,10,
.L14,6810,6877,67,7,
.L16,6877,6893,16,4,
.L15,6893,7102,209,8,
byte_reverse,7102,7292,190,8,
.LPIC1,7292,7500,208,8,
.L19,7500,8261,761,10,
.L18,8261,8441,180,8,
.L20,8441,8504,63,6,
.L22,8504,8520,16,4,
.L21,8520,8741,221,8,
sha_init,8741,9583,842,10,
sha_update,9583,10022,439,9,
.L25,10022,10291,269,9,
.L27,10291,10629,338,9,
.L26,10629,10982,353,9,
sha_final,10982,11875,893,10,
.L29,11875,12029,154,8,
.L30,12029,12477,448,9,
sha_stream,12477,12756,279,9,
.LPIC2,12756,12949,193,8,
.L33,12949,13106,157,8,
.L32,13106,13587,481,9,
.L34,13587,13673,86,7,
.L36,13673,13689,16,4,
.L35,13689,13825,136,8,
.LC0,13825,13997,172,8,
sha_print,13997,14407,410,9,
.LPIC3,14407,14509,102,7,
.L39,14509,14525,16,4,
.L38,14525,14531,59,6,
end,end,end,end,


LineNum,inLabel,command,JumpToLabel,jumpToAd,start_row_counter,
Label,StartPoint,EndPoint,Size,log_2,
empty,1,363,362,9,
sha_transform,363,559,196,8,
.LPIC0,559,697,138,8,
.L3,697,981,284,9,
.L2,981,1089,108,7,
.L5,1089,1653,564,10,
.L4,1653,2158,505,9,
.L7,2158,3035,877,10,
.L6,3035,3143,108,7,
.L9,3143,3959,816,10,
.L8,3959,4068,109,7,
.L11,4068,4981,913,10,
.L10,4981,5092,111,7,
.L13,5092,5909,817,10,
.L12,5909,6810,901,10,
.L14,6810,6877,67,7,
.L16,6877,6893,16,4,
.L15,6893,7102,209,8,
byte_reverse,7102,7292,190,8,
.LPIC1,7292,7500,208,8,
.L19,7500,8261,761,10,
.L18,8261,8441,180,8,
.L20,8441,8504,63,6,
.L22,8504,8520,16,4,
.L21,8520,8741,221,8,
sha_init,8741,9583,842,10,
sha_update,9583,10022,439,9,
.L25,10022,10291,269,9,
.L27,10291,10629,338,9,
.L26,10629,10982,353,9,
sha_final,10982,11875,893,10,
.L29,11875,12029,154,8,
.L30,12029,12477,448,9,
sha_stream,12477,12756,279,9,
.LPIC2,12756,12949,193,8,
.L33,12949,13106,157,8,
.L32,13106,13587,481,9,
.L34,13587,13673,86,7,
.L36,13673,13689,16,4,
.L35,13689,13825,136,8,
.LC0,13825,13997,172,8,
sha_print,13997,14407,410,9,
.LPIC3,14407,14509,102,7,
.L39,14509,14525,16,4,
.L38,14525,14531,59,6,
end,end,end,end,


LineNum,inLabel,command,JumpToLabel,jumpToAd,start_row_counter,
Label,StartPoint,EndPoint,Size,log_2,
empty,1,363,362,9,
sha_transform,363,559,196,8,
.LPIC0,559,697,138,8,
.L3,697,981,284,9,
.L2,981,1089,108,7,
.L5,1089,1653,564,10,
.L4,1653,2158,505,9,
.L7,2158,3035,877,10,
.L6,3035,3143,108,7,
.L9,3143,3959,816,10,
.L8,3959,4068,109,7,
.L11,4068,4981,913,10,
.L10,4981,5092,111,7,
.L13,5092,5909,817,10,
.L12,5909,6810,901,10,
.L14,6810,6877,67,7,
.L16,6877,6893,16,4,
.L15,6893,7102,209,8,
byte_reverse,7102,7292,190,8,
.LPIC1,7292,7500,208,8,
.L19,7500,8261,761,10,
.L18,8261,8441,180,8,
.L20,8441,8504,63,6,
.L22,8504,8520,16,4,
.L21,8520,8741,221,8,
sha_init,8741,9583,842,10,
sha_update,9583,10022,439,9,
.L25,10022,10291,269,9,
.L27,10291,10629,338,9,
.L26,10629,10982,353,9,
sha_final,10982,11875,893,10,
.L29,11875,12029,154,8,
.L30,12029,12477,448,9,
sha_stream,12477,12756,279,9,
.LPIC2,12756,12949,193,8,
.L33,12949,13106,157,8,
.L32,13106,13587,481,9,
.L34,13587,13673,86,7,
.L36,13673,13689,16,4,
.L35,13689,13825,136,8,
.LC0,13825,13997,172,8,
sha_print,13997,14407,410,9,
.LPIC3,14407,14509,102,7,
.L39,14509,14525,16,4,
.L38,14525,14531,59,6,
end,end,end,end,


LineNum,inLabel,command,JumpToLabel,jumpToAd,start_row_counter,
Label,StartPoint,EndPoint,Size,log_2,
empty,1,363,362,9,
sha_transform,363,559,196,8,
.LPIC0,559,697,138,8,
.L3,697,981,284,9,
.L2,981,1089,108,7,
.L5,1089,1653,564,10,
.L4,1653,2158,505,9,
.L7,2158,3035,877,10,
.L6,3035,3143,108,7,
.L9,3143,3959,816,10,
.L8,3959,4068,109,7,
.L11,4068,4981,913,10,
.L10,4981,5092,111,7,
.L13,5092,5909,817,10,
.L12,5909,6810,901,10,
.L14,6810,6877,67,7,
.L16,6877,6893,16,4,
.L15,6893,7102,209,8,
byte_reverse,7102,7292,190,8,
.LPIC1,7292,7500,208,8,
.L19,7500,8261,761,10,
.L18,8261,8441,180,8,
.L20,8441,8504,63,6,
.L22,8504,8520,16,4,
.L21,8520,8741,221,8,
sha_init,8741,9583,842,10,
sha_update,9583,10022,439,9,
.L25,10022,10291,269,9,
.L27,10291,10629,338,9,
.L26,10629,10982,353,9,
sha_final,10982,11875,893,10,
.L29,11875,12029,154,8,
.L30,12029,12477,448,9,
sha_stream,12477,12756,279,9,
.LPIC2,12756,12949,193,8,
.L33,12949,13106,157,8,
.L32,13106,13587,481,9,
.L34,13587,13673,86,7,
.L36,13673,13689,16,4,
.L35,13689,13825,136,8,
.LC0,13825,13997,172,8,
sha_print,13997,14407,410,9,
.LPIC3,14407,14509,102,7,
.L39,14509,14525,16,4,
.L38,14525,14531,59,6,
end,end,end,end,


LineNum,inLabel,command,JumpToLabel,jumpToAd,start_row_counter,
Label,StartPoint,EndPoint,Size,log_2,
empty,1,363,362,9,
sha_transform,363,559,196,8,
.LPIC0,559,697,138,8,
.L3,697,981,284,9,
.L2,981,1089,108,7,
.L5,1089,1653,564,10,
.L4,1653,2158,505,9,
.L7,2158,3035,877,10,
.L6,3035,3143,108,7,
.L9,3143,3959,816,10,
.L8,3959,4068,109,7,
.L11,4068,4981,913,10,
.L10,4981,5092,111,7,
.L13,5092,5909,817,10,
.L12,5909,6810,901,10,
.L14,6810,6877,67,7,
.L16,6877,6893,16,4,
.L15,6893,7102,209,8,
byte_reverse,7102,7292,190,8,
.LPIC1,7292,7500,208,8,
.L19,7500,8261,761,10,
.L18,8261,8441,180,8,
.L20,8441,8504,63,6,
.L22,8504,8520,16,4,
.L21,8520,8741,221,8,
sha_init,8741,9583,842,10,
sha_update,9583,10022,439,9,
.L25,10022,10291,269,9,
.L27,10291,10629,338,9,
.L26,10629,10982,353,9,
sha_final,10982,11875,893,10,
.L29,11875,12029,154,8,
.L30,12029,12477,448,9,
sha_stream,12477,12756,279,9,
.LPIC2,12756,12949,193,8,
.L33,12949,13106,157,8,
.L32,13106,13587,481,9,
.L34,13587,13673,86,7,
.L36,13673,13689,16,4,
.L35,13689,13825,136,8,
.LC0,13825,13997,172,8,
sha_print,13997,14407,410,9,
.LPIC3,14407,14509,102,7,
.L39,14509,14525,16,4,
.L38,14525,14531,59,6,
end,end,end,end,


LineNum,inLabel,command,JumpToLabel,jumpToAd,start_row_counter,
Label,StartPoint,EndPoint,Size,log_2,
empty,1,363,362,9,
sha_transform,363,559,196,8,
.LPIC0,559,697,138,8,
.L3,697,981,284,9,
.L2,981,1089,108,7,
.L5,1089,1653,564,10,
.L4,1653,2158,505,9,
.L7,2158,3035,877,10,
.L6,3035,3143,108,7,
.L9,3143,3959,816,10,
.L8,3959,4068,109,7,
.L11,4068,4981,913,10,
.L10,4981,5092,111,7,
.L13,5092,5909,817,10,
.L12,5909,6810,901,10,
.L14,6810,6877,67,7,
.L16,6877,6893,16,4,
.L15,6893,7102,209,8,
byte_reverse,7102,7292,190,8,
.LPIC1,7292,7500,208,8,
.L19,7500,8261,761,10,
.L18,8261,8441,180,8,
.L20,8441,8504,63,6,
.L22,8504,8520,16,4,
.L21,8520,8741,221,8,
sha_init,8741,9583,842,10,
sha_update,9583,10022,439,9,
.L25,10022,10291,269,9,
.L27,10291,10629,338,9,
.L26,10629,10982,353,9,
sha_final,10982,11875,893,10,
.L29,11875,12029,154,8,
.L30,12029,12477,448,9,
sha_stream,12477,12756,279,9,
.LPIC2,12756,12949,193,8,
.L33,12949,13106,157,8,
.L32,13106,13587,481,9,
.L34,13587,13673,86,7,
.L36,13673,13689,16,4,
.L35,13689,13825,136,8,
.LC0,13825,13997,172,8,
sha_print,13997,14407,410,9,
.LPIC3,14407,14509,102,7,
.L39,14509,14525,16,4,
.L38,14525,14531,59,6,
end,end,end,end,


LineNum,inLabel,command,JumpToLabel,jumpToAd,start_row_counter,
Label,StartPoint,EndPoint,Size,log_2,
empty,1,363,362,9,
sha_transform,363,559,196,8,
.LPIC0,559,697,138,8,
.L3,697,981,284,9,
.L2,981,1089,108,7,
.L5,1089,1653,564,10,
.L4,1653,2158,505,9,
.L7,2158,3035,877,10,
.L6,3035,3143,108,7,
.L9,3143,3959,816,10,
.L8,3959,4068,109,7,
.L11,4068,4981,913,10,
.L10,4981,5092,111,7,
.L13,5092,5909,817,10,
.L12,5909,6810,901,10,
.L14,6810,6877,67,7,
.L16,6877,6893,16,4,
.L15,6893,7102,209,8,
byte_reverse,7102,7292,190,8,
.LPIC1,7292,7500,208,8,
.L19,7500,8261,761,10,
.L18,8261,8441,180,8,
.L20,8441,8504,63,6,
.L22,8504,8520,16,4,
.L21,8520,8741,221,8,
sha_init,8741,9583,842,10,
sha_update,9583,10022,439,9,
.L25,10022,10291,269,9,
.L27,10291,10629,338,9,
.L26,10629,10982,353,9,
sha_final,10982,11875,893,10,
.L29,11875,12029,154,8,
.L30,12029,12477,448,9,
sha_stream,12477,12756,279,9,
.LPIC2,12756,12949,193,8,
.L33,12949,13106,157,8,
.L32,13106,13587,481,9,
.L34,13587,13673,86,7,
.L36,13673,13689,16,4,
.L35,13689,13825,136,8,
.LC0,13825,13997,172,8,
sha_print,13997,14407,410,9,
.LPIC3,14407,14509,102,7,
.L39,14509,14525,16,4,
.L38,14525,14531,59,6,
end,end,end,end,


LineNum,inLabel,command,JumpToLabel,jumpToAd,start_row_counter,
Label,StartPoint,EndPoint,Size,log_2,
empty,1,363,362,9,
sha_transform,363,559,196,8,
.LPIC0,559,697,138,8,
.L3,697,981,284,9,
.L2,981,1089,108,7,
.L5,1089,1653,564,10,
.L4,1653,2158,505,9,
.L7,2158,3035,877,10,
.L6,3035,3143,108,7,
.L9,3143,3959,816,10,
.L8,3959,4068,109,7,
.L11,4068,4981,913,10,
.L10,4981,5092,111,7,
.L13,5092,5909,817,10,
.L12,5909,6810,901,10,
.L14,6810,6877,67,7,
.L16,6877,6893,16,4,
.L15,6893,7102,209,8,
byte_reverse,7102,7292,190,8,
.LPIC1,7292,7500,208,8,
.L19,7500,8261,761,10,
.L18,8261,8441,180,8,
.L20,8441,8504,63,6,
.L22,8504,8520,16,4,
.L21,8520,8741,221,8,
sha_init,8741,9583,842,10,
sha_update,9583,10022,439,9,
.L25,10022,10291,269,9,
.L27,10291,10629,338,9,
.L26,10629,10982,353,9,
sha_final,10982,11875,893,10,
.L29,11875,12029,154,8,
.L30,12029,12477,448,9,
sha_stream,12477,12756,279,9,
.LPIC2,12756,12949,193,8,
.L33,12949,13106,157,8,
.L32,13106,13587,481,9,
.L34,13587,13673,86,7,
.L36,13673,13689,16,4,
.L35,13689,13825,136,8,
.LC0,13825,13997,172,8,
sha_print,13997,14407,410,9,
.LPIC3,14407,14509,102,7,
.L39,14509,14525,16,4,
.L38,14525,14531,59,6,
end,end,end,end,


LineNum,inLabel,command,JumpToLabel,jumpToAd,start_row_counter,
Label,StartPoint,EndPoint,Size,log_2,
empty,1,363,362,9,
sha_transform,363,559,196,8,
.LPIC0,559,697,138,8,
.L3,697,981,284,9,
.L2,981,1089,108,7,
.L5,1089,1653,564,10,
.L4,1653,2158,505,9,
.L7,2158,3035,877,10,
.L6,3035,3143,108,7,
.L9,3143,3959,816,10,
.L8,3959,4068,109,7,
.L11,4068,4981,913,10,
.L10,4981,5092,111,7,
.L13,5092,5909,817,10,
.L12,5909,6810,901,10,
.L14,6810,6877,67,7,
.L16,6877,6893,16,4,
.L15,6893,7102,209,8,
byte_reverse,7102,7292,190,8,
.LPIC1,7292,7500,208,8,
.L19,7500,8261,761,10,
.L18,8261,8441,180,8,
.L20,8441,8504,63,6,
.L22,8504,8520,16,4,
.L21,8520,8741,221,8,
sha_init,8741,9583,842,10,
sha_update,9583,10022,439,9,
.L25,10022,10291,269,9,
.L27,10291,10629,338,9,
.L26,10629,10982,353,9,
sha_final,10982,11875,893,10,
.L29,11875,12029,154,8,
.L30,12029,12477,448,9,
sha_stream,12477,12756,279,9,
.LPIC2,12756,12949,193,8,
.L33,12949,13106,157,8,
.L32,13106,13587,481,9,
.L34,13587,13673,86,7,
.L36,13673,13689,16,4,
.L35,13689,13825,136,8,
.LC0,13825,13997,172,8,
sha_print,13997,14407,410,9,
.LPIC3,14407,14509,102,7,
.L39,14509,14525,16,4,
.L38,14525,14531,59,6,
end,end,end,end,


LineNum,inLabel,command,JumpToLabel,jumpToAd,start_row_counter,
Label,StartPoint,EndPoint,Size,log_2,
empty,1,363,362,9,
sha_transform,363,559,196,8,
.LPIC0,559,697,138,8,
.L3,697,981,284,9,
.L2,981,1089,108,7,
.L5,1089,1653,564,10,
.L4,1653,2158,505,9,
.L7,2158,3035,877,10,
.L6,3035,3143,108,7,
.L9,3143,3959,816,10,
.L8,3959,4068,109,7,
.L11,4068,4981,913,10,
.L10,4981,5092,111,7,
.L13,5092,5909,817,10,
.L12,5909,6810,901,10,
.L14,6810,6877,67,7,
.L16,6877,6893,16,4,
.L15,6893,7102,209,8,
byte_reverse,7102,7292,190,8,
.LPIC1,7292,7500,208,8,
.L19,7500,8261,761,10,
.L18,8261,8441,180,8,
.L20,8441,8504,63,6,
.L22,8504,8520,16,4,
.L21,8520,8741,221,8,
sha_init,8741,9583,842,10,
sha_update,9583,10022,439,9,
.L25,10022,10291,269,9,
.L27,10291,10629,338,9,
.L26,10629,10982,353,9,
sha_final,10982,11875,893,10,
.L29,11875,12029,154,8,
.L30,12029,12477,448,9,
sha_stream,12477,12756,279,9,
.LPIC2,12756,12949,193,8,
.L33,12949,13106,157,8,
.L32,13106,13587,481,9,
.L34,13587,13673,86,7,
.L36,13673,13689,16,4,
.L35,13689,13825,136,8,
.LC0,13825,13997,172,8,
sha_print,13997,14407,410,9,
.LPIC3,14407,14509,102,7,
.L39,14509,14525,16,4,
.L38,14525,14531,59,6,
end,end,end,end,


LineNum,inLabel,command,JumpToLabel,jumpToAd,start_row_counter,
Label,StartPoint,EndPoint,Size,log_2,
empty,1,363,362,9,
sha_transform,363,559,196,8,
.LPIC0,559,697,138,8,
.L3,697,981,284,9,
.L2,981,1089,108,7,
.L5,1089,1653,564,10,
.L4,1653,2158,505,9,
.L7,2158,3035,877,10,
.L6,3035,3143,108,7,
.L9,3143,3959,816,10,
.L8,3959,4068,109,7,
.L11,4068,4981,913,10,
.L10,4981,5092,111,7,
.L13,5092,5909,817,10,
.L12,5909,6810,901,10,
.L14,6810,6877,67,7,
.L16,6877,6893,16,4,
.L15,6893,7102,209,8,
byte_reverse,7102,7292,190,8,
.LPIC1,7292,7500,208,8,
.L19,7500,8261,761,10,
.L18,8261,8441,180,8,
.L20,8441,8504,63,6,
.L22,8504,8520,16,4,
.L21,8520,8741,221,8,
sha_init,8741,9583,842,10,
sha_update,9583,10022,439,9,
.L25,10022,10291,269,9,
.L27,10291,10629,338,9,
.L26,10629,10982,353,9,
sha_final,10982,11875,893,10,
.L29,11875,12029,154,8,
.L30,12029,12477,448,9,
sha_stream,12477,12756,279,9,
.LPIC2,12756,12949,193,8,
.L33,12949,13106,157,8,
.L32,13106,13587,481,9,
.L34,13587,13673,86,7,
.L36,13673,13689,16,4,
.L35,13689,13825,136,8,
.LC0,13825,13997,172,8,
sha_print,13997,14407,410,9,
.LPIC3,14407,14509,102,7,
.L39,14509,14525,16,4,
.L38,14525,14531,59,6,
end,end,end,end,


LineNum,inLabel,command,JumpToLabel,jumpToAd,start_row_counter,
Label,StartPoint,EndPoint,Size,log_2,
empty,1,363,362,9,
sha_transform,363,559,196,8,
.LPIC0,559,697,138,8,
.L3,697,981,284,9,
.L2,981,1089,108,7,
.L5,1089,1653,564,10,
.L4,1653,2158,505,9,
.L7,2158,3035,877,10,
.L6,3035,3143,108,7,
.L9,3143,3959,816,10,
.L8,3959,4068,109,7,
.L11,4068,4981,913,10,
.L10,4981,5092,111,7,
.L13,5092,5909,817,10,
.L12,5909,6810,901,10,
.L14,6810,6877,67,7,
.L16,6877,6893,16,4,
.L15,6893,7102,209,8,
byte_reverse,7102,7292,190,8,
.LPIC1,7292,7500,208,8,
.L19,7500,8261,761,10,
.L18,8261,8441,180,8,
.L20,8441,8504,63,6,
.L22,8504,8520,16,4,
.L21,8520,8741,221,8,
sha_init,8741,9583,842,10,
sha_update,9583,10022,439,9,
.L25,10022,10291,269,9,
.L27,10291,10629,338,9,
.L26,10629,10982,353,9,
sha_final,10982,11875,893,10,
.L29,11875,12029,154,8,
.L30,12029,12477,448,9,
sha_stream,12477,12756,279,9,
.LPIC2,12756,12949,193,8,
.L33,12949,13106,157,8,
.L32,13106,13587,481,9,
.L34,13587,13673,86,7,
.L36,13673,13689,16,4,
.L35,13689,13825,136,8,
.LC0,13825,13997,172,8,
sha_print,13997,14407,410,9,
.LPIC3,14407,14509,102,7,
.L39,14509,14525,16,4,
.L38,14525,14531,59,6,
end,end,end,end,


LineNum,inLabel,command,JumpToLabel,jumpToAd,start_row_counter,
Label,StartPoint,EndPoint,Size,log_2,
empty,1,363,362,9,
sha_transform,363,559,196,8,
.LPIC0,559,697,138,8,
.L3,697,981,284,9,
.L2,981,1089,108,7,
.L5,1089,1653,564,10,
.L4,1653,2158,505,9,
.L7,2158,3035,877,10,
.L6,3035,3143,108,7,
.L9,3143,3959,816,10,
.L8,3959,4068,109,7,
.L11,4068,4981,913,10,
.L10,4981,5092,111,7,
.L13,5092,5909,817,10,
.L12,5909,6810,901,10,
.L14,6810,6877,67,7,
.L16,6877,6893,16,4,
.L15,6893,7102,209,8,
byte_reverse,7102,7292,190,8,
.LPIC1,7292,7500,208,8,
.L19,7500,8261,761,10,
.L18,8261,8441,180,8,
.L20,8441,8504,63,6,
.L22,8504,8520,16,4,
.L21,8520,8741,221,8,
sha_init,8741,9583,842,10,
sha_update,9583,10022,439,9,
.L25,10022,10291,269,9,
.L27,10291,10629,338,9,
.L26,10629,10982,353,9,
sha_final,10982,11875,893,10,
.L29,11875,12029,154,8,
.L30,12029,12477,448,9,
sha_stream,12477,12756,279,9,
.LPIC2,12756,12949,193,8,
.L33,12949,13106,157,8,
.L32,13106,13587,481,9,
.L34,13587,13673,86,7,
.L36,13673,13689,16,4,
.L35,13689,13825,136,8,
.LC0,13825,13997,172,8,
sha_print,13997,14407,410,9,
.LPIC3,14407,14509,102,7,
.L39,14509,14525,16,4,
.L38,14525,14531,59,6,
end,end,end,end,


LineNum,inLabel,command,JumpToLabel,jumpToAd,start_row_counter,
Label,StartPoint,EndPoint,Size,log_2,
empty,1,363,362,9,
sha_transform,363,559,196,8,
.LPIC0,559,697,138,8,
.L3,697,981,284,9,
.L2,981,1089,108,7,
.L5,1089,1653,564,10,
.L4,1653,2158,505,9,
.L7,2158,3035,877,10,
.L6,3035,3143,108,7,
.L9,3143,3959,816,10,
.L8,3959,4068,109,7,
.L11,4068,4981,913,10,
.L10,4981,5092,111,7,
.L13,5092,5909,817,10,
.L12,5909,6810,901,10,
.L14,6810,6877,67,7,
.L16,6877,6893,16,4,
.L15,6893,7102,209,8,
byte_reverse,7102,7292,190,8,
.LPIC1,7292,7500,208,8,
.L19,7500,8261,761,10,
.L18,8261,8441,180,8,
.L20,8441,8504,63,6,
.L22,8504,8520,16,4,
.L21,8520,8741,221,8,
sha_init,8741,9583,842,10,
sha_update,9583,10022,439,9,
.L25,10022,10291,269,9,
.L27,10291,10629,338,9,
.L26,10629,10982,353,9,
sha_final,10982,11875,893,10,
.L29,11875,12029,154,8,
.L30,12029,12477,448,9,
sha_stream,12477,12756,279,9,
.LPIC2,12756,12949,193,8,
.L33,12949,13106,157,8,
.L32,13106,13587,481,9,
.L34,13587,13673,86,7,
.L36,13673,13689,16,4,
.L35,13689,13825,136,8,
.LC0,13825,13997,172,8,
sha_print,13997,14407,410,9,
.LPIC3,14407,14509,102,7,
.L39,14509,14525,16,4,
.L38,14525,14531,59,6,
end,end,end,end,


LineNum,inLabel,command,JumpToLabel,jumpToAd,start_row_counter,
Label,StartPoint,EndPoint,Size,log_2,
empty,1,363,362,9,
sha_transform,363,559,196,8,
.LPIC0,559,697,138,8,
.L3,697,981,284,9,
.L2,981,1089,108,7,
.L5,1089,1653,564,10,
.L4,1653,2158,505,9,
.L7,2158,3035,877,10,
.L6,3035,3143,108,7,
.L9,3143,3959,816,10,
.L8,3959,4068,109,7,
.L11,4068,4981,913,10,
.L10,4981,5092,111,7,
.L13,5092,5909,817,10,
.L12,5909,6810,901,10,
.L14,6810,6877,67,7,
.L16,6877,6893,16,4,
.L15,6893,7102,209,8,
byte_reverse,7102,7292,190,8,
.LPIC1,7292,7500,208,8,
.L19,7500,8261,761,10,
.L18,8261,8441,180,8,
.L20,8441,8504,63,6,
.L22,8504,8520,16,4,
.L21,8520,8741,221,8,
sha_init,8741,9583,842,10,
sha_update,9583,10022,439,9,
.L25,10022,10291,269,9,
.L27,10291,10629,338,9,
.L26,10629,10982,353,9,
sha_final,10982,11875,893,10,
.L29,11875,12029,154,8,
.L30,12029,12477,448,9,
sha_stream,12477,12756,279,9,
.LPIC2,12756,12949,193,8,
.L33,12949,13106,157,8,
.L32,13106,13587,481,9,
.L34,13587,13673,86,7,
.L36,13673,13689,16,4,
.L35,13689,13825,136,8,
.LC0,13825,13997,172,8,
sha_print,13997,14407,410,9,
.LPIC3,14407,14509,102,7,
.L39,14509,14525,16,4,
.L38,14525,14531,59,6,
end,end,end,end,


LineNum,inLabel,command,JumpToLabel,jumpToAd,start_row_counter,
Label,StartPoint,EndPoint,Size,log_2,
empty,1,363,362,9,
sha_transform,363,559,196,8,
.LPIC0,559,697,138,8,
.L3,697,981,284,9,
.L2,981,1089,108,7,
.L5,1089,1653,564,10,
.L4,1653,2158,505,9,
.L7,2158,3035,877,10,
.L6,3035,3143,108,7,
.L9,3143,3959,816,10,
.L8,3959,4068,109,7,
.L11,4068,4981,913,10,
.L10,4981,5092,111,7,
.L13,5092,5909,817,10,
.L12,5909,6810,901,10,
.L14,6810,6877,67,7,
.L16,6877,6893,16,4,
.L15,6893,7102,209,8,
byte_reverse,7102,7292,190,8,
.LPIC1,7292,7500,208,8,
.L19,7500,8261,761,10,
.L18,8261,8441,180,8,
.L20,8441,8504,63,6,
.L22,8504,8520,16,4,
.L21,8520,8741,221,8,
sha_init,8741,9583,842,10,
sha_update,9583,10022,439,9,
.L25,10022,10291,269,9,
.L27,10291,10629,338,9,
.L26,10629,10982,353,9,
sha_final,10982,11875,893,10,
.L29,11875,12029,154,8,
.L30,12029,12477,448,9,
sha_stream,12477,12756,279,9,
.LPIC2,12756,12949,193,8,
.L33,12949,13106,157,8,
.L32,13106,13587,481,9,
.L34,13587,13673,86,7,
.L36,13673,13689,16,4,
.L35,13689,13825,136,8,
.LC0,13825,13997,172,8,
sha_print,13997,14407,410,9,
.LPIC3,14407,14509,102,7,
.L39,14509,14525,16,4,
.L38,14525,14531,59,6,
end,end,end,end,


LineNum,inLabel,command,JumpToLabel,jumpToAd,start_row_counter,
Label,StartPoint,EndPoint,Size,log_2,
empty,1,363,362,9,
sha_transform,363,559,196,8,
.LPIC0,559,697,138,8,
.L3,697,981,284,9,
.L2,981,1089,108,7,
.L5,1089,1653,564,10,
.L4,1653,2158,505,9,
.L7,2158,3035,877,10,
.L6,3035,3143,108,7,
.L9,3143,3959,816,10,
.L8,3959,4068,109,7,
.L11,4068,4981,913,10,
.L10,4981,5092,111,7,
.L13,5092,5909,817,10,
.L12,5909,6810,901,10,
.L14,6810,6877,67,7,
.L16,6877,6893,16,4,
.L15,6893,7102,209,8,
byte_reverse,7102,7292,190,8,
.LPIC1,7292,7500,208,8,
.L19,7500,8261,761,10,
.L18,8261,8441,180,8,
.L20,8441,8504,63,6,
.L22,8504,8520,16,4,
.L21,8520,8741,221,8,
sha_init,8741,9583,842,10,
sha_update,9583,10022,439,9,
.L25,10022,10291,269,9,
.L27,10291,10629,338,9,
.L26,10629,10982,353,9,
sha_final,10982,11875,893,10,
.L29,11875,12029,154,8,
.L30,12029,12477,448,9,
sha_stream,12477,12756,279,9,
.LPIC2,12756,12949,193,8,
.L33,12949,13106,157,8,
.L32,13106,13587,481,9,
.L34,13587,13673,86,7,
.L36,13673,13689,16,4,
.L35,13689,13825,136,8,
.LC0,13825,13997,172,8,
sha_print,13997,14407,410,9,
.LPIC3,14407,14509,102,7,
.L39,14509,14525,16,4,
.L38,14525,14531,59,6,
end,end,end,end,


LineNum,inLabel,command,JumpToLabel,jumpToAd,start_row_counter,
Label,StartPoint,EndPoint,Size,log_2,
empty,1,363,362,9,
sha_transform,363,559,196,8,
.LPIC0,559,697,138,8,
.L3,697,981,284,9,
.L2,981,1089,108,7,
.L5,1089,1653,564,10,
.L4,1653,2158,505,9,
.L7,2158,3035,877,10,
.L6,3035,3143,108,7,
.L9,3143,3959,816,10,
.L8,3959,4068,109,7,
.L11,4068,4981,913,10,
.L10,4981,5092,111,7,
.L13,5092,5909,817,10,
.L12,5909,6810,901,10,
.L14,6810,6877,67,7,
.L16,6877,6893,16,4,
.L15,6893,7102,209,8,
byte_reverse,7102,7292,190,8,
.LPIC1,7292,7500,208,8,
.L19,7500,8261,761,10,
.L18,8261,8441,180,8,
.L20,8441,8504,63,6,
.L22,8504,8520,16,4,
.L21,8520,8741,221,8,
sha_init,8741,9583,842,10,
sha_update,9583,10022,439,9,
.L25,10022,10291,269,9,
.L27,10291,10629,338,9,
.L26,10629,10982,353,9,
sha_final,10982,11875,893,10,
.L29,11875,12029,154,8,
.L30,12029,12477,448,9,
sha_stream,12477,12756,279,9,
.LPIC2,12756,12949,193,8,
.L33,12949,13106,157,8,
.L32,13106,13587,481,9,
.L34,13587,13673,86,7,
.L36,13673,13689,16,4,
.L35,13689,13825,136,8,
.LC0,13825,13997,172,8,
sha_print,13997,14407,410,9,
.LPIC3,14407,14509,102,7,
.L39,14509,14525,16,4,
.L38,14525,14531,59,6,
end,end,end,end,


LineNum,inLabel,command,JumpToLabel,jumpToAd,start_row_counter,
Label,StartPoint,EndPoint,Size,log_2,
empty,1,363,362,9,
sha_transform,363,559,196,8,
.LPIC0,559,697,138,8,
.L3,697,981,284,9,
.L2,981,1089,108,7,
.L5,1089,1653,564,10,
.L4,1653,2158,505,9,
.L7,2158,3035,877,10,
.L6,3035,3143,108,7,
.L9,3143,3959,816,10,
.L8,3959,4068,109,7,
.L11,4068,4981,913,10,
.L10,4981,5092,111,7,
.L13,5092,5909,817,10,
.L12,5909,6810,901,10,
.L14,6810,6877,67,7,
.L16,6877,6893,16,4,
.L15,6893,7102,209,8,
byte_reverse,7102,7292,190,8,
.LPIC1,7292,7500,208,8,
.L19,7500,8261,761,10,
.L18,8261,8441,180,8,
.L20,8441,8504,63,6,
.L22,8504,8520,16,4,
.L21,8520,8741,221,8,
sha_init,8741,9583,842,10,
sha_update,9583,10022,439,9,
.L25,10022,10291,269,9,
.L27,10291,10629,338,9,
.L26,10629,10982,353,9,
sha_final,10982,11875,893,10,
.L29,11875,12029,154,8,
.L30,12029,12477,448,9,
sha_stream,12477,12756,279,9,
.LPIC2,12756,12949,193,8,
.L33,12949,13106,157,8,
.L32,13106,13587,481,9,
.L34,13587,13673,86,7,
.L36,13673,13689,16,4,
.L35,13689,13825,136,8,
.LC0,13825,13997,172,8,
sha_print,13997,14407,410,9,
.LPIC3,14407,14509,102,7,
.L39,14509,14525,16,4,
.L38,14525,14531,59,6,
end,end,end,end,


LineNum,inLabel,command,JumpToLabel,jumpToAd,start_row_counter,
Label,StartPoint,EndPoint,Size,log_2,
empty,1,363,362,9,
sha_transform,363,559,196,8,
.LPIC0,559,697,138,8,
.L3,697,981,284,9,
.L2,981,1089,108,7,
.L5,1089,1653,564,10,
.L4,1653,2158,505,9,
.L7,2158,3035,877,10,
.L6,3035,3143,108,7,
.L9,3143,3959,816,10,
.L8,3959,4068,109,7,
.L11,4068,4981,913,10,
.L10,4981,5092,111,7,
.L13,5092,5909,817,10,
.L12,5909,6810,901,10,
.L14,6810,6877,67,7,
.L16,6877,6893,16,4,
.L15,6893,7102,209,8,
byte_reverse,7102,7292,190,8,
.LPIC1,7292,7500,208,8,
.L19,7500,8261,761,10,
.L18,8261,8441,180,8,
.L20,8441,8504,63,6,
.L22,8504,8520,16,4,
.L21,8520,8741,221,8,
sha_init,8741,9583,842,10,
sha_update,9583,10022,439,9,
.L25,10022,10291,269,9,
.L27,10291,10629,338,9,
.L26,10629,10982,353,9,
sha_final,10982,11875,893,10,
.L29,11875,12029,154,8,
.L30,12029,12477,448,9,
sha_stream,12477,12756,279,9,
.LPIC2,12756,12949,193,8,
.L33,12949,13106,157,8,
.L32,13106,13587,481,9,
.L34,13587,13673,86,7,
.L36,13673,13689,16,4,
.L35,13689,13825,136,8,
.LC0,13825,13997,172,8,
sha_print,13997,14407,410,9,
.LPIC3,14407,14509,102,7,
.L39,14509,14525,16,4,
.L38,14525,14531,59,6,
end,end,end,end,


LineNum,inLabel,command,JumpToLabel,jumpToAd,start_row_counter,
Label,StartPoint,EndPoint,Size,log_2,
empty,1,363,362,9,
sha_transform,363,559,196,8,
.LPIC0,559,697,138,8,
.L3,697,981,284,9,
.L2,981,1089,108,7,
.L5,1089,1653,564,10,
.L4,1653,2158,505,9,
.L7,2158,3035,877,10,
.L6,3035,3143,108,7,
.L9,3143,3959,816,10,
.L8,3959,4068,109,7,
.L11,4068,4981,913,10,
.L10,4981,5092,111,7,
.L13,5092,5909,817,10,
.L12,5909,6810,901,10,
.L14,6810,6877,67,7,
.L16,6877,6893,16,4,
.L15,6893,7102,209,8,
byte_reverse,7102,7292,190,8,
.LPIC1,7292,7500,208,8,
.L19,7500,8261,761,10,
.L18,8261,8441,180,8,
.L20,8441,8504,63,6,
.L22,8504,8520,16,4,
.L21,8520,8741,221,8,
sha_init,8741,9583,842,10,
sha_update,9583,10022,439,9,
.L25,10022,10291,269,9,
.L27,10291,10629,338,9,
.L26,10629,10982,353,9,
sha_final,10982,11875,893,10,
.L29,11875,12029,154,8,
.L30,12029,12477,448,9,
sha_stream,12477,12756,279,9,
.LPIC2,12756,12949,193,8,
.L33,12949,13106,157,8,
.L32,13106,13587,481,9,
.L34,13587,13673,86,7,
.L36,13673,13689,16,4,
.L35,13689,13825,136,8,
.LC0,13825,13997,172,8,
sha_print,13997,14407,410,9,
.LPIC3,14407,14509,102,7,
.L39,14509,14525,16,4,
.L38,14525,14531,59,6,
end,end,end,end,


LineNum,inLabel,command,JumpToLabel,jumpToAd,start_row_counter,
Label,StartPoint,EndPoint,Size,log_2,
empty,1,363,362,9,
sha_transform,363,559,196,8,
.LPIC0,559,697,138,8,
.L3,697,981,284,9,
.L2,981,1089,108,7,
.L5,1089,1653,564,10,
.L4,1653,2158,505,9,
.L7,2158,3035,877,10,
.L6,3035,3143,108,7,
.L9,3143,3959,816,10,
.L8,3959,4068,109,7,
.L11,4068,4981,913,10,
.L10,4981,5092,111,7,
.L13,5092,5909,817,10,
.L12,5909,6810,901,10,
.L14,6810,6877,67,7,
.L16,6877,6893,16,4,
.L15,6893,7102,209,8,
byte_reverse,7102,7292,190,8,
.LPIC1,7292,7500,208,8,
.L19,7500,8261,761,10,
.L18,8261,8441,180,8,
.L20,8441,8504,63,6,
.L22,8504,8520,16,4,
.L21,8520,8741,221,8,
sha_init,8741,9583,842,10,
sha_update,9583,10022,439,9,
.L25,10022,10291,269,9,
.L27,10291,10629,338,9,
.L26,10629,10982,353,9,
sha_final,10982,11875,893,10,
.L29,11875,12029,154,8,
.L30,12029,12477,448,9,
sha_stream,12477,12756,279,9,
.LPIC2,12756,12949,193,8,
.L33,12949,13106,157,8,
.L32,13106,13587,481,9,
.L34,13587,13673,86,7,
.L36,13673,13689,16,4,
.L35,13689,13825,136,8,
.LC0,13825,13997,172,8,
sha_print,13997,14407,410,9,
.LPIC3,14407,14509,102,7,
.L39,14509,14525,16,4,
.L38,14525,14531,59,6,
end,end,end,end,


LineNum,inLabel,command,JumpToLabel,jumpToAd,start_row_counter,
Label,StartPoint,EndPoint,Size,log_2,
empty,1,363,362,9,
sha_transform,363,559,196,8,
.LPIC0,559,697,138,8,
.L3,697,981,284,9,
.L2,981,1089,108,7,
.L5,1089,1653,564,10,
.L4,1653,2158,505,9,
.L7,2158,3035,877,10,
.L6,3035,3143,108,7,
.L9,3143,3959,816,10,
.L8,3959,4068,109,7,
.L11,4068,4981,913,10,
.L10,4981,5092,111,7,
.L13,5092,5909,817,10,
.L12,5909,6810,901,10,
.L14,6810,6877,67,7,
.L16,6877,6893,16,4,
.L15,6893,7102,209,8,
byte_reverse,7102,7292,190,8,
.LPIC1,7292,7500,208,8,
.L19,7500,8261,761,10,
.L18,8261,8441,180,8,
.L20,8441,8504,63,6,
.L22,8504,8520,16,4,
.L21,8520,8741,221,8,
sha_init,8741,9583,842,10,
sha_update,9583,10022,439,9,
.L25,10022,10291,269,9,
.L27,10291,10629,338,9,
.L26,10629,10982,353,9,
sha_final,10982,11875,893,10,
.L29,11875,12029,154,8,
.L30,12029,12477,448,9,
sha_stream,12477,12756,279,9,
.LPIC2,12756,12949,193,8,
.L33,12949,13106,157,8,
.L32,13106,13587,481,9,
.L34,13587,13673,86,7,
.L36,13673,13689,16,4,
.L35,13689,13825,136,8,
.LC0,13825,13997,172,8,
sha_print,13997,14407,410,9,
.LPIC3,14407,14509,102,7,
.L39,14509,14525,16,4,
.L38,14525,14531,59,6,
end,end,end,end,


LineNum,inLabel,command,JumpToLabel,jumpToAd,start_row_counter,
Label,StartPoint,EndPoint,Size,log_2,
empty,1,363,362,9,
sha_transform,363,559,196,8,
.LPIC0,559,697,138,8,
.L3,697,981,284,9,
.L2,981,1089,108,7,
.L5,1089,1653,564,10,
.L4,1653,2158,505,9,
.L7,2158,3035,877,10,
.L6,3035,3143,108,7,
.L9,3143,3959,816,10,
.L8,3959,4068,109,7,
.L11,4068,4981,913,10,
.L10,4981,5092,111,7,
.L13,5092,5909,817,10,
.L12,5909,6810,901,10,
.L14,6810,6877,67,7,
.L16,6877,6893,16,4,
.L15,6893,7102,209,8,
byte_reverse,7102,7292,190,8,
.LPIC1,7292,7500,208,8,
.L19,7500,8261,761,10,
.L18,8261,8441,180,8,
.L20,8441,8504,63,6,
.L22,8504,8520,16,4,
.L21,8520,8741,221,8,
sha_init,8741,9583,842,10,
sha_update,9583,10022,439,9,
.L25,10022,10291,269,9,
.L27,10291,10629,338,9,
.L26,10629,10982,353,9,
sha_final,10982,11875,893,10,
.L29,11875,12029,154,8,
.L30,12029,12477,448,9,
sha_stream,12477,12756,279,9,
.LPIC2,12756,12949,193,8,
.L33,12949,13106,157,8,
.L32,13106,13587,481,9,
.L34,13587,13673,86,7,
.L36,13673,13689,16,4,
.L35,13689,13825,136,8,
.LC0,13825,13997,172,8,
sha_print,13997,14407,410,9,
.LPIC3,14407,14509,102,7,
.L39,14509,14525,16,4,
.L38,14525,14531,59,6,
end,end,end,end,


LineNum,inLabel,command,JumpToLabel,jumpToAd,start_row_counter,
Label,StartPoint,EndPoint,Size,log_2,
empty,1,363,362,9,
sha_transform,363,559,196,8,
.LPIC0,559,697,138,8,
.L3,697,981,284,9,
.L2,981,1089,108,7,
.L5,1089,1653,564,10,
.L4,1653,2158,505,9,
.L7,2158,3035,877,10,
.L6,3035,3143,108,7,
.L9,3143,3959,816,10,
.L8,3959,4068,109,7,
.L11,4068,4981,913,10,
.L10,4981,5092,111,7,
.L13,5092,5909,817,10,
.L12,5909,6810,901,10,
.L14,6810,6877,67,7,
.L16,6877,6893,16,4,
.L15,6893,7102,209,8,
byte_reverse,7102,7292,190,8,
.LPIC1,7292,7500,208,8,
.L19,7500,8261,761,10,
.L18,8261,8441,180,8,
.L20,8441,8504,63,6,
.L22,8504,8520,16,4,
.L21,8520,8741,221,8,
sha_init,8741,9583,842,10,
sha_update,9583,10022,439,9,
.L25,10022,10291,269,9,
.L27,10291,10629,338,9,
.L26,10629,10982,353,9,
sha_final,10982,11875,893,10,
.L29,11875,12029,154,8,
.L30,12029,12477,448,9,
sha_stream,12477,12756,279,9,
.LPIC2,12756,12949,193,8,
.L33,12949,13106,157,8,
.L32,13106,13587,481,9,
.L34,13587,13673,86,7,
.L36,13673,13689,16,4,
.L35,13689,13825,136,8,
.LC0,13825,13997,172,8,
sha_print,13997,14407,410,9,
.LPIC3,14407,14509,102,7,
.L39,14509,14525,16,4,
.L38,14525,14531,59,6,
end,end,end,end,


LineNum,inLabel,command,JumpToLabel,jumpToAd,start_row_counter,
Label,StartPoint,EndPoint,Size,log_2,
empty,1,363,362,9,
sha_transform,363,559,196,8,
.LPIC0,559,697,138,8,
.L3,697,981,284,9,
.L2,981,1089,108,7,
.L5,1089,1653,564,10,
.L4,1653,2158,505,9,
.L7,2158,3035,877,10,
.L6,3035,3143,108,7,
.L9,3143,3959,816,10,
.L8,3959,4068,109,7,
.L11,4068,4981,913,10,
.L10,4981,5092,111,7,
.L13,5092,5909,817,10,
.L12,5909,6810,901,10,
.L14,6810,6877,67,7,
.L16,6877,6893,16,4,
.L15,6893,7102,209,8,
byte_reverse,7102,7292,190,8,
.LPIC1,7292,7500,208,8,
.L19,7500,8261,761,10,
.L18,8261,8441,180,8,
.L20,8441,8504,63,6,
.L22,8504,8520,16,4,
.L21,8520,8741,221,8,
sha_init,8741,9583,842,10,
sha_update,9583,10022,439,9,
.L25,10022,10291,269,9,
.L27,10291,10629,338,9,
.L26,10629,10982,353,9,
sha_final,10982,11875,893,10,
.L29,11875,12029,154,8,
.L30,12029,12477,448,9,
sha_stream,12477,12756,279,9,
.LPIC2,12756,12949,193,8,
.L33,12949,13106,157,8,
.L32,13106,13587,481,9,
.L34,13587,13673,86,7,
.L36,13673,13689,16,4,
.L35,13689,13825,136,8,
.LC0,13825,13997,172,8,
sha_print,13997,14407,410,9,
.LPIC3,14407,14509,102,7,
.L39,14509,14525,16,4,
.L38,14525,14531,59,6,
end,end,end,end,


LineNum,inLabel,command,JumpToLabel,jumpToAd,start_row_counter,
Label,StartPoint,EndPoint,Size,log_2,
empty,1,363,362,9,
sha_transform,363,559,196,8,
.LPIC0,559,697,138,8,
.L3,697,981,284,9,
.L2,981,1089,108,7,
.L5,1089,1653,564,10,
.L4,1653,2158,505,9,
.L7,2158,3035,877,10,
.L6,3035,3143,108,7,
.L9,3143,3959,816,10,
.L8,3959,4068,109,7,
.L11,4068,4981,913,10,
.L10,4981,5092,111,7,
.L13,5092,5909,817,10,
.L12,5909,6810,901,10,
.L14,6810,6877,67,7,
.L16,6877,6893,16,4,
.L15,6893,7102,209,8,
byte_reverse,7102,7292,190,8,
.LPIC1,7292,7500,208,8,
.L19,7500,8261,761,10,
.L18,8261,8441,180,8,
.L20,8441,8504,63,6,
.L22,8504,8520,16,4,
.L21,8520,8741,221,8,
sha_init,8741,9583,842,10,
sha_update,9583,10022,439,9,
.L25,10022,10291,269,9,
.L27,10291,10629,338,9,
.L26,10629,10982,353,9,
sha_final,10982,11875,893,10,
.L29,11875,12029,154,8,
.L30,12029,12477,448,9,
sha_stream,12477,12756,279,9,
.LPIC2,12756,12949,193,8,
.L33,12949,13106,157,8,
.L32,13106,13587,481,9,
.L34,13587,13673,86,7,
.L36,13673,13689,16,4,
.L35,13689,13825,136,8,
.LC0,13825,13997,172,8,
sha_print,13997,14407,410,9,
.LPIC3,14407,14509,102,7,
.L39,14509,14525,16,4,
.L38,14525,14531,59,6,
end,end,end,end,


LineNum,inLabel,command,JumpToLabel,jumpToAd,start_row_counter,
Label,StartPoint,EndPoint,Size,log_2,
empty,1,363,362,9,
sha_transform,363,559,196,8,
.LPIC0,559,697,138,8,
.L3,697,981,284,9,
.L2,981,1089,108,7,
.L5,1089,1653,564,10,
.L4,1653,2158,505,9,
.L7,2158,3035,877,10,
.L6,3035,3143,108,7,
.L9,3143,3959,816,10,
.L8,3959,4068,109,7,
.L11,4068,4981,913,10,
.L10,4981,5092,111,7,
.L13,5092,5909,817,10,
.L12,5909,6810,901,10,
.L14,6810,6877,67,7,
.L16,6877,6893,16,4,
.L15,6893,7102,209,8,
byte_reverse,7102,7292,190,8,
.LPIC1,7292,7500,208,8,
.L19,7500,8261,761,10,
.L18,8261,8441,180,8,
.L20,8441,8504,63,6,
.L22,8504,8520,16,4,
.L21,8520,8741,221,8,
sha_init,8741,9583,842,10,
sha_update,9583,10022,439,9,
.L25,10022,10291,269,9,
.L27,10291,10629,338,9,
.L26,10629,10982,353,9,
sha_final,10982,11875,893,10,
.L29,11875,12029,154,8,
.L30,12029,12477,448,9,
sha_stream,12477,12756,279,9,
.LPIC2,12756,12949,193,8,
.L33,12949,13106,157,8,
.L32,13106,13587,481,9,
.L34,13587,13673,86,7,
.L36,13673,13689,16,4,
.L35,13689,13825,136,8,
.LC0,13825,13997,172,8,
sha_print,13997,14407,410,9,
.LPIC3,14407,14509,102,7,
.L39,14509,14525,16,4,
.L38,14525,14531,59,6,
end,end,end,end,


LineNum,inLabel,command,JumpToLabel,jumpToAd,start_row_counter,
Label,StartPoint,EndPoint,Size,log_2,
empty,1,363,362,9,
sha_transform,363,559,196,8,
.LPIC0,559,697,138,8,
.L3,697,981,284,9,
.L2,981,1089,108,7,
.L5,1089,1653,564,10,
.L4,1653,2158,505,9,
.L7,2158,3035,877,10,
.L6,3035,3143,108,7,
.L9,3143,3959,816,10,
.L8,3959,4068,109,7,
.L11,4068,4981,913,10,
.L10,4981,5092,111,7,
.L13,5092,5909,817,10,
.L12,5909,6810,901,10,
.L14,6810,6877,67,7,
.L16,6877,6893,16,4,
.L15,6893,7102,209,8,
byte_reverse,7102,7292,190,8,
.LPIC1,7292,7500,208,8,
.L19,7500,8261,761,10,
.L18,8261,8441,180,8,
.L20,8441,8504,63,6,
.L22,8504,8520,16,4,
.L21,8520,8741,221,8,
sha_init,8741,9583,842,10,
sha_update,9583,10022,439,9,
.L25,10022,10291,269,9,
.L27,10291,10629,338,9,
.L26,10629,10982,353,9,
sha_final,10982,11875,893,10,
.L29,11875,12029,154,8,
.L30,12029,12477,448,9,
sha_stream,12477,12756,279,9,
.LPIC2,12756,12949,193,8,
.L33,12949,13106,157,8,
.L32,13106,13587,481,9,
.L34,13587,13673,86,7,
.L36,13673,13689,16,4,
.L35,13689,13825,136,8,
.LC0,13825,13997,172,8,
sha_print,13997,14407,410,9,
.LPIC3,14407,14509,102,7,
.L39,14509,14525,16,4,
.L38,14525,14531,59,6,
end,end,end,end,


LineNum,inLabel,command,JumpToLabel,jumpToAd,start_row_counter,
Label,StartPoint,EndPoint,Size,log_2,
empty,1,363,362,9,
sha_transform,363,559,196,8,
.LPIC0,559,697,138,8,
.L3,697,981,284,9,
.L2,981,1089,108,7,
.L5,1089,1653,564,10,
.L4,1653,2158,505,9,
.L7,2158,3035,877,10,
.L6,3035,3143,108,7,
.L9,3143,3959,816,10,
.L8,3959,4068,109,7,
.L11,4068,4981,913,10,
.L10,4981,5092,111,7,
.L13,5092,5909,817,10,
.L12,5909,6810,901,10,
.L14,6810,6877,67,7,
.L16,6877,6893,16,4,
.L15,6893,7102,209,8,
byte_reverse,7102,7292,190,8,
.LPIC1,7292,7500,208,8,
.L19,7500,8261,761,10,
.L18,8261,8441,180,8,
.L20,8441,8504,63,6,
.L22,8504,8520,16,4,
.L21,8520,8741,221,8,
sha_init,8741,9583,842,10,
sha_update,9583,10022,439,9,
.L25,10022,10291,269,9,
.L27,10291,10629,338,9,
.L26,10629,10982,353,9,
sha_final,10982,11875,893,10,
.L29,11875,12029,154,8,
.L30,12029,12477,448,9,
sha_stream,12477,12756,279,9,
.LPIC2,12756,12949,193,8,
.L33,12949,13106,157,8,
.L32,13106,13587,481,9,
.L34,13587,13673,86,7,
.L36,13673,13689,16,4,
.L35,13689,13825,136,8,
.LC0,13825,13997,172,8,
sha_print,13997,14407,410,9,
.LPIC3,14407,14509,102,7,
.L39,14509,14525,16,4,
.L38,14525,14531,59,6,
end,end,end,end,


LineNum,inLabel,command,JumpToLabel,jumpToAd,start_row_counter,
Label,StartPoint,EndPoint,Size,log_2,
empty,1,363,362,9,
sha_transform,363,559,196,8,
.LPIC0,559,697,138,8,
.L3,697,981,284,9,
.L2,981,1089,108,7,
.L5,1089,1653,564,10,
.L4,1653,2158,505,9,
.L7,2158,3035,877,10,
.L6,3035,3143,108,7,
.L9,3143,3959,816,10,
.L8,3959,4068,109,7,
.L11,4068,4981,913,10,
.L10,4981,5092,111,7,
.L13,5092,5909,817,10,
.L12,5909,6810,901,10,
.L14,6810,6877,67,7,
.L16,6877,6893,16,4,
.L15,6893,7102,209,8,
byte_reverse,7102,7292,190,8,
.LPIC1,7292,7500,208,8,
.L19,7500,8261,761,10,
.L18,8261,8441,180,8,
.L20,8441,8504,63,6,
.L22,8504,8520,16,4,
.L21,8520,8741,221,8,
sha_init,8741,9583,842,10,
sha_update,9583,10022,439,9,
.L25,10022,10291,269,9,
.L27,10291,10629,338,9,
.L26,10629,10982,353,9,
sha_final,10982,11875,893,10,
.L29,11875,12029,154,8,
.L30,12029,12477,448,9,
sha_stream,12477,12756,279,9,
.LPIC2,12756,12949,193,8,
.L33,12949,13106,157,8,
.L32,13106,13587,481,9,
.L34,13587,13673,86,7,
.L36,13673,13689,16,4,
.L35,13689,13825,136,8,
.LC0,13825,13997,172,8,
sha_print,13997,14407,410,9,
.LPIC3,14407,14509,102,7,
.L39,14509,14525,16,4,
.L38,14525,14531,59,6,
end,end,end,end,


LineNum,inLabel,command,JumpToLabel,jumpToAd,start_row_counter,
Label,StartPoint,EndPoint,Size,log_2,
empty,1,363,362,9,
sha_transform,363,559,196,8,
.LPIC0,559,697,138,8,
.L3,697,981,284,9,
.L2,981,1089,108,7,
.L5,1089,1653,564,10,
.L4,1653,2158,505,9,
.L7,2158,3035,877,10,
.L6,3035,3143,108,7,
.L9,3143,3959,816,10,
.L8,3959,4068,109,7,
.L11,4068,4981,913,10,
.L10,4981,5092,111,7,
.L13,5092,5909,817,10,
.L12,5909,6810,901,10,
.L14,6810,6877,67,7,
.L16,6877,6893,16,4,
.L15,6893,7102,209,8,
byte_reverse,7102,7292,190,8,
.LPIC1,7292,7500,208,8,
.L19,7500,8261,761,10,
.L18,8261,8441,180,8,
.L20,8441,8504,63,6,
.L22,8504,8520,16,4,
.L21,8520,8741,221,8,
sha_init,8741,9583,842,10,
sha_update,9583,10022,439,9,
.L25,10022,10291,269,9,
.L27,10291,10629,338,9,
.L26,10629,10982,353,9,
sha_final,10982,11875,893,10,
.L29,11875,12029,154,8,
.L30,12029,12477,448,9,
sha_stream,12477,12756,279,9,
.LPIC2,12756,12949,193,8,
.L33,12949,13106,157,8,
.L32,13106,13587,481,9,
.L34,13587,13673,86,7,
.L36,13673,13689,16,4,
.L35,13689,13825,136,8,
.LC0,13825,13997,172,8,
sha_print,13997,14407,410,9,
.LPIC3,14407,14509,102,7,
.L39,14509,14525,16,4,
.L38,14525,14531,59,6,
end,end,end,end,


LineNum,inLabel,command,JumpToLabel,jumpToAd,start_row_counter,
Label,StartPoint,EndPoint,Size,log_2,
empty,1,363,362,9,
sha_transform,363,559,196,8,
.LPIC0,559,697,138,8,
.L3,697,981,284,9,
.L2,981,1089,108,7,
.L5,1089,1653,564,10,
.L4,1653,2158,505,9,
.L7,2158,3035,877,10,
.L6,3035,3143,108,7,
.L9,3143,3959,816,10,
.L8,3959,4068,109,7,
.L11,4068,4981,913,10,
.L10,4981,5092,111,7,
.L13,5092,5909,817,10,
.L12,5909,6810,901,10,
.L14,6810,6877,67,7,
.L16,6877,6893,16,4,
.L15,6893,7102,209,8,
byte_reverse,7102,7292,190,8,
.LPIC1,7292,7500,208,8,
.L19,7500,8261,761,10,
.L18,8261,8441,180,8,
.L20,8441,8504,63,6,
.L22,8504,8520,16,4,
.L21,8520,8741,221,8,
sha_init,8741,9583,842,10,
sha_update,9583,10022,439,9,
.L25,10022,10291,269,9,
.L27,10291,10629,338,9,
.L26,10629,10982,353,9,
sha_final,10982,11875,893,10,
.L29,11875,12029,154,8,
.L30,12029,12477,448,9,
sha_stream,12477,12756,279,9,
.LPIC2,12756,12949,193,8,
.L33,12949,13106,157,8,
.L32,13106,13587,481,9,
.L34,13587,13673,86,7,
.L36,13673,13689,16,4,
.L35,13689,13825,136,8,
.LC0,13825,13997,172,8,
sha_print,13997,14407,410,9,
.LPIC3,14407,14509,102,7,
.L39,14509,14525,16,4,
.L38,14525,14531,59,6,
end,end,end,end,


LineNum,inLabel,command,JumpToLabel,jumpToAd,start_row_counter,
Label,StartPoint,EndPoint,Size,log_2,
empty,1,363,362,9,
sha_transform,363,559,196,8,
.LPIC0,559,697,138,8,
.L3,697,981,284,9,
.L2,981,1089,108,7,
.L5,1089,1653,564,10,
.L4,1653,2158,505,9,
.L7,2158,3035,877,10,
.L6,3035,3143,108,7,
.L9,3143,3959,816,10,
.L8,3959,4068,109,7,
.L11,4068,4981,913,10,
.L10,4981,5092,111,7,
.L13,5092,5909,817,10,
.L12,5909,6810,901,10,
.L14,6810,6877,67,7,
.L16,6877,6893,16,4,
.L15,6893,7102,209,8,
byte_reverse,7102,7292,190,8,
.LPIC1,7292,7500,208,8,
.L19,7500,8261,761,10,
.L18,8261,8441,180,8,
.L20,8441,8504,63,6,
.L22,8504,8520,16,4,
.L21,8520,8741,221,8,
sha_init,8741,9583,842,10,
sha_update,9583,10022,439,9,
.L25,10022,10291,269,9,
.L27,10291,10629,338,9,
.L26,10629,10982,353,9,
sha_final,10982,11875,893,10,
.L29,11875,12029,154,8,
.L30,12029,12477,448,9,
sha_stream,12477,12756,279,9,
.LPIC2,12756,12949,193,8,
.L33,12949,13106,157,8,
.L32,13106,13587,481,9,
.L34,13587,13673,86,7,
.L36,13673,13689,16,4,
.L35,13689,13825,136,8,
.LC0,13825,13997,172,8,
sha_print,13997,14407,410,9,
.LPIC3,14407,14509,102,7,
.L39,14509,14525,16,4,
.L38,14525,14531,59,6,
end,end,end,end,


LineNum,inLabel,command,JumpToLabel,jumpToAd,start_row_counter,
Label,StartPoint,EndPoint,Size,log_2,
empty,1,363,362,9,
sha_transform,363,559,196,8,
.LPIC0,559,697,138,8,
.L3,697,981,284,9,
.L2,981,1089,108,7,
.L5,1089,1653,564,10,
.L4,1653,2158,505,9,
.L7,2158,3035,877,10,
.L6,3035,3143,108,7,
.L9,3143,3959,816,10,
.L8,3959,4068,109,7,
.L11,4068,4981,913,10,
.L10,4981,5092,111,7,
.L13,5092,5909,817,10,
.L12,5909,6810,901,10,
.L14,6810,6877,67,7,
.L16,6877,6893,16,4,
.L15,6893,7102,209,8,
byte_reverse,7102,7292,190,8,
.LPIC1,7292,7500,208,8,
.L19,7500,8261,761,10,
.L18,8261,8441,180,8,
.L20,8441,8504,63,6,
.L22,8504,8520,16,4,
.L21,8520,8741,221,8,
sha_init,8741,9583,842,10,
sha_update,9583,10022,439,9,
.L25,10022,10291,269,9,
.L27,10291,10629,338,9,
.L26,10629,10982,353,9,
sha_final,10982,11875,893,10,
.L29,11875,12029,154,8,
.L30,12029,12477,448,9,
sha_stream,12477,12756,279,9,
.LPIC2,12756,12949,193,8,
.L33,12949,13106,157,8,
.L32,13106,13587,481,9,
.L34,13587,13673,86,7,
.L36,13673,13689,16,4,
.L35,13689,13825,136,8,
.LC0,13825,13997,172,8,
sha_print,13997,14407,410,9,
.LPIC3,14407,14509,102,7,
.L39,14509,14525,16,4,
.L38,14525,14531,59,6,
end,end,end,end,


LineNum,inLabel,command,JumpToLabel,jumpToAd,start_row_counter,
Label,StartPoint,EndPoint,Size,log_2,
empty,1,363,362,9,
sha_transform,363,559,196,8,
.LPIC0,559,697,138,8,
.L3,697,981,284,9,
.L2,981,1089,108,7,
.L5,1089,1653,564,10,
.L4,1653,2158,505,9,
.L7,2158,3035,877,10,
.L6,3035,3143,108,7,
.L9,3143,3959,816,10,
.L8,3959,4068,109,7,
.L11,4068,4981,913,10,
.L10,4981,5092,111,7,
.L13,5092,5909,817,10,
.L12,5909,6810,901,10,
.L14,6810,6877,67,7,
.L16,6877,6893,16,4,
.L15,6893,7102,209,8,
byte_reverse,7102,7292,190,8,
.LPIC1,7292,7500,208,8,
.L19,7500,8261,761,10,
.L18,8261,8441,180,8,
.L20,8441,8504,63,6,
.L22,8504,8520,16,4,
.L21,8520,8741,221,8,
sha_init,8741,9583,842,10,
sha_update,9583,10022,439,9,
.L25,10022,10291,269,9,
.L27,10291,10629,338,9,
.L26,10629,10982,353,9,
sha_final,10982,11875,893,10,
.L29,11875,12029,154,8,
.L30,12029,12477,448,9,
sha_stream,12477,12756,279,9,
.LPIC2,12756,12949,193,8,
.L33,12949,13106,157,8,
.L32,13106,13587,481,9,
.L34,13587,13673,86,7,
.L36,13673,13689,16,4,
.L35,13689,13825,136,8,
.LC0,13825,13997,172,8,
sha_print,13997,14407,410,9,
.LPIC3,14407,14509,102,7,
.L39,14509,14525,16,4,
.L38,14525,14531,59,6,
end,end,end,end,


LineNum,inLabel,command,JumpToLabel,jumpToAd,start_row_counter,
Label,StartPoint,EndPoint,Size,log_2,
empty,1,363,362,9,
sha_transform,363,559,196,8,
.LPIC0,559,697,138,8,
.L3,697,981,284,9,
.L2,981,1089,108,7,
.L5,1089,1653,564,10,
.L4,1653,2158,505,9,
.L7,2158,3035,877,10,
.L6,3035,3143,108,7,
.L9,3143,3959,816,10,
.L8,3959,4068,109,7,
.L11,4068,4981,913,10,
.L10,4981,5092,111,7,
.L13,5092,5909,817,10,
.L12,5909,6810,901,10,
.L14,6810,6877,67,7,
.L16,6877,6893,16,4,
.L15,6893,7102,209,8,
byte_reverse,7102,7292,190,8,
.LPIC1,7292,7500,208,8,
.L19,7500,8261,761,10,
.L18,8261,8441,180,8,
.L20,8441,8504,63,6,
.L22,8504,8520,16,4,
.L21,8520,8741,221,8,
sha_init,8741,9583,842,10,
sha_update,9583,10022,439,9,
.L25,10022,10291,269,9,
.L27,10291,10629,338,9,
.L26,10629,10982,353,9,
sha_final,10982,11875,893,10,
.L29,11875,12029,154,8,
.L30,12029,12477,448,9,
sha_stream,12477,12756,279,9,
.LPIC2,12756,12949,193,8,
.L33,12949,13106,157,8,
.L32,13106,13587,481,9,
.L34,13587,13673,86,7,
.L36,13673,13689,16,4,
.L35,13689,13825,136,8,
.LC0,13825,13997,172,8,
sha_print,13997,14407,410,9,
.LPIC3,14407,14509,102,7,
.L39,14509,14525,16,4,
.L38,14525,14531,59,6,
end,end,end,end,


LineNum,inLabel,command,JumpToLabel,jumpToAd,start_row_counter,
Label,StartPoint,EndPoint,Size,log_2,
empty,1,363,362,9,
sha_transform,363,559,196,8,
.LPIC0,559,697,138,8,
.L3,697,981,284,9,
.L2,981,1089,108,7,
.L5,1089,1653,564,10,
.L4,1653,2158,505,9,
.L7,2158,3035,877,10,
.L6,3035,3143,108,7,
.L9,3143,3959,816,10,
.L8,3959,4068,109,7,
.L11,4068,4981,913,10,
.L10,4981,5092,111,7,
.L13,5092,5909,817,10,
.L12,5909,6810,901,10,
.L14,6810,6877,67,7,
.L16,6877,6893,16,4,
.L15,6893,7102,209,8,
byte_reverse,7102,7292,190,8,
.LPIC1,7292,7500,208,8,
.L19,7500,8261,761,10,
.L18,8261,8441,180,8,
.L20,8441,8504,63,6,
.L22,8504,8520,16,4,
.L21,8520,8741,221,8,
sha_init,8741,9583,842,10,
sha_update,9583,10022,439,9,
.L25,10022,10291,269,9,
.L27,10291,10629,338,9,
.L26,10629,10982,353,9,
sha_final,10982,11875,893,10,
.L29,11875,12029,154,8,
.L30,12029,12477,448,9,
sha_stream,12477,12756,279,9,
.LPIC2,12756,12949,193,8,
.L33,12949,13106,157,8,
.L32,13106,13587,481,9,
.L34,13587,13673,86,7,
.L36,13673,13689,16,4,
.L35,13689,13825,136,8,
.LC0,13825,13997,172,8,
sha_print,13997,14407,410,9,
.LPIC3,14407,14509,102,7,
.L39,14509,14525,16,4,
.L38,14525,14531,59,6,
end,end,end,end,


LineNum,inLabel,command,JumpToLabel,jumpToAd,start_row_counter,
Label,StartPoint,EndPoint,Size,log_2,
empty,0,363,363,9,
sha_transform,363,559,196,8,
.LPIC0,559,697,138,8,
.L3,697,981,284,9,
.L2,981,1089,108,7,
.L5,1089,1653,564,10,
.L4,1653,2158,505,9,
.L7,2158,3035,877,10,
.L6,3035,3143,108,7,
.L9,3143,3959,816,10,
.L8,3959,4068,109,7,
.L11,4068,4981,913,10,
.L10,4981,5092,111,7,
.L13,5092,5909,817,10,
.L12,5909,6810,901,10,
.L14,6810,6877,67,7,
.L16,6877,6893,16,4,
.L15,6893,7102,209,8,
byte_reverse,7102,7292,190,8,
.LPIC1,7292,7500,208,8,
.L19,7500,8261,761,10,
.L18,8261,8441,180,8,
.L20,8441,8504,63,6,
.L22,8504,8520,16,4,
.L21,8520,8741,221,8,
sha_init,8741,9583,842,10,
sha_update,9583,10022,439,9,
.L25,10022,10291,269,9,
.L27,10291,10629,338,9,
.L26,10629,10982,353,9,
sha_final,10982,11875,893,10,
.L29,11875,12029,154,8,
.L30,12029,12477,448,9,
sha_stream,12477,12756,279,9,
.LPIC2,12756,12949,193,8,
.L33,12949,13106,157,8,
.L32,13106,13587,481,9,
.L34,13587,13673,86,7,
.L36,13673,13689,16,4,
.L35,13689,13825,136,8,
.LC0,13825,13997,172,8,
sha_print,13997,14407,410,9,
.LPIC3,14407,14509,102,7,
.L39,14509,14525,16,4,
.L38,14525,14531,59,6,
end,end,end,end,


LineNum,inLabel,command,JumpToLabel,jumpToAd,start_row_counter,
Label,StartPoint,EndPoint,Size,log_2,
empty,1,363,362,9,
sha_transform,363,559,196,8,
.LPIC0,559,697,138,8,
.L3,697,981,284,9,
.L2,981,1089,108,7,
.L5,1089,1653,564,10,
.L4,1653,2158,505,9,
.L7,2158,3035,877,10,
.L6,3035,3143,108,7,
.L9,3143,3959,816,10,
.L8,3959,4068,109,7,
.L11,4068,4981,913,10,
.L10,4981,5092,111,7,
.L13,5092,5909,817,10,
.L12,5909,6810,901,10,
.L14,6810,6877,67,7,
.L16,6877,6893,16,4,
.L15,6893,7102,209,8,
byte_reverse,7102,7292,190,8,
.LPIC1,7292,7500,208,8,
.L19,7500,8261,761,10,
.L18,8261,8441,180,8,
.L20,8441,8504,63,6,
.L22,8504,8520,16,4,
.L21,8520,8741,221,8,
sha_init,8741,9583,842,10,
sha_update,9583,10022,439,9,
.L25,10022,10291,269,9,
.L27,10291,10629,338,9,
.L26,10629,10982,353,9,
sha_final,10982,11875,893,10,
.L29,11875,12029,154,8,
.L30,12029,12477,448,9,
sha_stream,12477,12756,279,9,
.LPIC2,12756,12949,193,8,
.L33,12949,13106,157,8,
.L32,13106,13587,481,9,
.L34,13587,13673,86,7,
.L36,13673,13689,16,4,
.L35,13689,13825,136,8,
.LC0,13825,13997,172,8,
sha_print,13997,14407,410,9,
.LPIC3,14407,14509,102,7,
.L39,14509,14525,16,4,
.L38,14525,14531,59,6,
end,end,end,end,


LineNum,inLabel,command,JumpToLabel,jumpToAd,start_row_counter,
Label,StartPoint,EndPoint,Size,log_2,
empty,1,363,362,9,
sha_transform,363,559,196,8,
.LPIC0,559,697,138,8,
.L3,697,981,284,9,
.L2,981,1089,108,7,
.L5,1089,1653,564,10,
.L4,1653,2158,505,9,
.L7,2158,3035,877,10,
.L6,3035,3143,108,7,
.L9,3143,3959,816,10,
.L8,3959,4068,109,7,
.L11,4068,4981,913,10,
.L10,4981,5092,111,7,
.L13,5092,5909,817,10,
.L12,5909,6810,901,10,
.L14,6810,6877,67,7,
.L16,6877,6893,16,4,
.L15,6893,7102,209,8,
byte_reverse,7102,7292,190,8,
.LPIC1,7292,7500,208,8,
.L19,7500,8261,761,10,
.L18,8261,8441,180,8,
.L20,8441,8504,63,6,
.L22,8504,8520,16,4,
.L21,8520,8741,221,8,
sha_init,8741,9583,842,10,
sha_update,9583,10022,439,9,
.L25,10022,10291,269,9,
.L27,10291,10629,338,9,
.L26,10629,10982,353,9,
sha_final,10982,11875,893,10,
.L29,11875,12029,154,8,
.L30,12029,12477,448,9,
sha_stream,12477,12756,279,9,
.LPIC2,12756,12949,193,8,
.L33,12949,13106,157,8,
.L32,13106,13587,481,9,
.L34,13587,13673,86,7,
.L36,13673,13689,16,4,
.L35,13689,13825,136,8,
.LC0,13825,13997,172,8,
sha_print,13997,14407,410,9,
.LPIC3,14407,14509,102,7,
.L39,14509,14525,16,4,
.L38,14525,14531,59,6,
end,end,end,end,


LineNum,inLabel,command,JumpToLabel,jumpToAd,start_row_counter,
Label,StartPoint,EndPoint,Size,log_2,
empty,1,363,362,9,
sha_transform,363,559,196,8,
.LPIC0,559,697,138,8,
.L3,697,981,284,9,
.L2,981,1089,108,7,
.L5,1089,1653,564,10,
.L4,1653,2158,505,9,
.L7,2158,3035,877,10,
.L6,3035,3143,108,7,
.L9,3143,3959,816,10,
.L8,3959,4068,109,7,
.L11,4068,4981,913,10,
.L10,4981,5092,111,7,
.L13,5092,5909,817,10,
.L12,5909,6810,901,10,
.L14,6810,6877,67,7,
.L16,6877,6893,16,4,
.L15,6893,7102,209,8,
byte_reverse,7102,7292,190,8,
.LPIC1,7292,7500,208,8,
.L19,7500,8261,761,10,
.L18,8261,8441,180,8,
.L20,8441,8504,63,6,
.L22,8504,8520,16,4,
.L21,8520,8741,221,8,
sha_init,8741,9583,842,10,
sha_update,9583,10022,439,9,
.L25,10022,10291,269,9,
.L27,10291,10629,338,9,
.L26,10629,10982,353,9,
sha_final,10982,11875,893,10,
.L29,11875,12029,154,8,
.L30,12029,12477,448,9,
sha_stream,12477,12756,279,9,
.LPIC2,12756,12949,193,8,
.L33,12949,13106,157,8,
.L32,13106,13587,481,9,
.L34,13587,13673,86,7,
.L36,13673,13689,16,4,
.L35,13689,13825,136,8,
.LC0,13825,13997,172,8,
sha_print,13997,14407,410,9,
.LPIC3,14407,14509,102,7,
.L39,14509,14525,16,4,
.L38,14525,14531,59,6,
end,end,end,end,


LineNum,inLabel,command,JumpToLabel,jumpToAd,start_row_counter,
Label,StartPoint,EndPoint,Size,log_2,
empty,1,363,362,9,
sha_transform,363,559,196,8,
.LPIC0,559,697,138,8,
.L3,697,981,284,9,
.L2,981,1089,108,7,
.L5,1089,1653,564,10,
.L4,1653,2158,505,9,
.L7,2158,3035,877,10,
.L6,3035,3143,108,7,
.L9,3143,3959,816,10,
.L8,3959,4068,109,7,
.L11,4068,4981,913,10,
.L10,4981,5092,111,7,
.L13,5092,5909,817,10,
.L12,5909,6810,901,10,
.L14,6810,6877,67,7,
.L16,6877,6893,16,4,
.L15,6893,7102,209,8,
byte_reverse,7102,7292,190,8,
.LPIC1,7292,7500,208,8,
.L19,7500,8261,761,10,
.L18,8261,8441,180,8,
.L20,8441,8504,63,6,
.L22,8504,8520,16,4,
.L21,8520,8741,221,8,
sha_init,8741,9583,842,10,
sha_update,9583,10022,439,9,
.L25,10022,10291,269,9,
.L27,10291,10629,338,9,
.L26,10629,10982,353,9,
sha_final,10982,11875,893,10,
.L29,11875,12029,154,8,
.L30,12029,12477,448,9,
sha_stream,12477,12756,279,9,
.LPIC2,12756,12949,193,8,
.L33,12949,13106,157,8,
.L32,13106,13587,481,9,
.L34,13587,13673,86,7,
.L36,13673,13689,16,4,
.L35,13689,13825,136,8,
.LC0,13825,13997,172,8,
sha_print,13997,14407,410,9,
.LPIC3,14407,14509,102,7,
.L39,14509,14525,16,4,
.L38,14525,14531,59,6,
end,end,end,end,


LineNum,inLabel,command,JumpToLabel,jumpToAd,start_row_counter,
Label,StartPoint,EndPoint,Size,log_2,
empty,1,363,362,9,
sha_transform,363,559,196,8,
.LPIC0,559,697,138,8,
.L3,697,981,284,9,
.L2,981,1089,108,7,
.L5,1089,1653,564,10,
.L4,1653,2158,505,9,
.L7,2158,3035,877,10,
.L6,3035,3143,108,7,
.L9,3143,3959,816,10,
.L8,3959,4068,109,7,
.L11,4068,4981,913,10,
.L10,4981,5092,111,7,
.L13,5092,5909,817,10,
.L12,5909,6810,901,10,
.L14,6810,6877,67,7,
.L16,6877,6893,16,4,
.L15,6893,7102,209,8,
byte_reverse,7102,7292,190,8,
.LPIC1,7292,7500,208,8,
.L19,7500,8261,761,10,
.L18,8261,8441,180,8,
.L20,8441,8504,63,6,
.L22,8504,8520,16,4,
.L21,8520,8741,221,8,
sha_init,8741,9583,842,10,
sha_update,9583,10022,439,9,
.L25,10022,10291,269,9,
.L27,10291,10629,338,9,
.L26,10629,10982,353,9,
sha_final,10982,11875,893,10,
.L29,11875,12029,154,8,
.L30,12029,12477,448,9,
sha_stream,12477,12756,279,9,
.LPIC2,12756,12949,193,8,
.L33,12949,13106,157,8,
.L32,13106,13587,481,9,
.L34,13587,13673,86,7,
.L36,13673,13689,16,4,
.L35,13689,13825,136,8,
.LC0,13825,13997,172,8,
sha_print,13997,14407,410,9,
.LPIC3,14407,14509,102,7,
.L39,14509,14525,16,4,
.L38,14525,14531,59,6,
end,end,end,end,


LineNum,inLabel,command,JumpToLabel,jumpToAd,start_row_counter,
Label,StartPoint,EndPoint,Size,log_2,
empty,1,363,362,9,
sha_transform,363,559,196,8,
.LPIC0,559,697,138,8,
.L3,697,981,284,9,
.L2,981,1089,108,7,
.L5,1089,1653,564,10,
.L4,1653,2158,505,9,
.L7,2158,3035,877,10,
.L6,3035,3143,108,7,
.L9,3143,3959,816,10,
.L8,3959,4068,109,7,
.L11,4068,4981,913,10,
.L10,4981,5092,111,7,
.L13,5092,5909,817,10,
.L12,5909,6810,901,10,
.L14,6810,6877,67,7,
.L16,6877,6893,16,4,
.L15,6893,7102,209,8,
byte_reverse,7102,7292,190,8,
.LPIC1,7292,7500,208,8,
.L19,7500,8261,761,10,
.L18,8261,8441,180,8,
.L20,8441,8504,63,6,
.L22,8504,8520,16,4,
.L21,8520,8741,221,8,
sha_init,8741,9583,842,10,
sha_update,9583,10022,439,9,
.L25,10022,10291,269,9,
.L27,10291,10629,338,9,
.L26,10629,10982,353,9,
sha_final,10982,11875,893,10,
.L29,11875,12029,154,8,
.L30,12029,12477,448,9,
sha_stream,12477,12756,279,9,
.LPIC2,12756,12949,193,8,
.L33,12949,13106,157,8,
.L32,13106,13587,481,9,
.L34,13587,13673,86,7,
.L36,13673,13689,16,4,
.L35,13689,13825,136,8,
.LC0,13825,13997,172,8,
sha_print,13997,14407,410,9,
.LPIC3,14407,14509,102,7,
.L39,14509,14525,16,4,
.L38,14525,14531,59,6,
end,end,end,end,


LineNum,inLabel,command,JumpToLabel,jumpToAd,start_row_counter,
Label,StartPoint,EndPoint,Size,log_2,
empty,1,363,362,9,
sha_transform,363,559,196,8,
.LPIC0,559,697,138,8,
.L3,697,981,284,9,
.L2,981,1089,108,7,
.L5,1089,1653,564,10,
.L4,1653,2158,505,9,
.L7,2158,3035,877,10,
.L6,3035,3143,108,7,
.L9,3143,3959,816,10,
.L8,3959,4068,109,7,
.L11,4068,4981,913,10,
.L10,4981,5092,111,7,
.L13,5092,5909,817,10,
.L12,5909,6810,901,10,
.L14,6810,6877,67,7,
.L16,6877,6893,16,4,
.L15,6893,7102,209,8,
byte_reverse,7102,7292,190,8,
.LPIC1,7292,7500,208,8,
.L19,7500,8261,761,10,
.L18,8261,8441,180,8,
.L20,8441,8504,63,6,
.L22,8504,8520,16,4,
.L21,8520,8741,221,8,
sha_init,8741,9583,842,10,
sha_update,9583,10022,439,9,
.L25,10022,10291,269,9,
.L27,10291,10629,338,9,
.L26,10629,10982,353,9,
sha_final,10982,11875,893,10,
.L29,11875,12029,154,8,
.L30,12029,12477,448,9,
sha_stream,12477,12756,279,9,
.LPIC2,12756,12949,193,8,
.L33,12949,13106,157,8,
.L32,13106,13587,481,9,
.L34,13587,13673,86,7,
.L36,13673,13689,16,4,
.L35,13689,13825,136,8,
.LC0,13825,13997,172,8,
sha_print,13997,14407,410,9,
.LPIC3,14407,14509,102,7,
.L39,14509,14525,16,4,
.L38,14525,14531,59,6,
end,end,end,end,


LineNum,inLabel,command,JumpToLabel,jumpToAd,start_row_counter,
Label,StartPoint,EndPoint,Size,log_2,
empty,1,363,362,9,
sha_transform,363,559,196,8,
.LPIC0,559,697,138,8,
.L3,697,981,284,9,
.L2,981,1089,108,7,
.L5,1089,1653,564,10,
.L4,1653,2158,505,9,
.L7,2158,3035,877,10,
.L6,3035,3143,108,7,
.L9,3143,3959,816,10,
.L8,3959,4068,109,7,
.L11,4068,4981,913,10,
.L10,4981,5092,111,7,
.L13,5092,5909,817,10,
.L12,5909,6810,901,10,
.L14,6810,6877,67,7,
.L16,6877,6893,16,4,
.L15,6893,7102,209,8,
byte_reverse,7102,7292,190,8,
.LPIC1,7292,7500,208,8,
.L19,7500,8261,761,10,
.L18,8261,8441,180,8,
.L20,8441,8504,63,6,
.L22,8504,8520,16,4,
.L21,8520,8741,221,8,
sha_init,8741,9583,842,10,
sha_update,9583,10022,439,9,
.L25,10022,10291,269,9,
.L27,10291,10629,338,9,
.L26,10629,10982,353,9,
sha_final,10982,11875,893,10,
.L29,11875,12029,154,8,
.L30,12029,12477,448,9,
sha_stream,12477,12756,279,9,
.LPIC2,12756,12949,193,8,
.L33,12949,13106,157,8,
.L32,13106,13587,481,9,
.L34,13587,13673,86,7,
.L36,13673,13689,16,4,
.L35,13689,13825,136,8,
.LC0,13825,13997,172,8,
sha_print,13997,14407,410,9,
.LPIC3,14407,14509,102,7,
.L39,14509,14525,16,4,
.L38,14525,14531,59,6,
end,end,end,end,


LineNum,inLabel,command,JumpToLabel,jumpToAd,start_row_counter,
Label,StartPoint,EndPoint,Size,log_2,
empty,1,363,362,9,
sha_transform,363,559,196,8,
.LPIC0,559,697,138,8,
.L3,697,981,284,9,
.L2,981,1089,108,7,
.L5,1089,1653,564,10,
.L4,1653,2158,505,9,
.L7,2158,3035,877,10,
.L6,3035,3143,108,7,
.L9,3143,3959,816,10,
.L8,3959,4068,109,7,
.L11,4068,4981,913,10,
.L10,4981,5092,111,7,
.L13,5092,5909,817,10,
.L12,5909,6810,901,10,
.L14,6810,6877,67,7,
.L16,6877,6893,16,4,
.L15,6893,7102,209,8,
byte_reverse,7102,7292,190,8,
.LPIC1,7292,7500,208,8,
.L19,7500,8261,761,10,
.L18,8261,8441,180,8,
.L20,8441,8504,63,6,
.L22,8504,8520,16,4,
.L21,8520,8741,221,8,
sha_init,8741,9583,842,10,
sha_update,9583,10022,439,9,
.L25,10022,10291,269,9,
.L27,10291,10629,338,9,
.L26,10629,10982,353,9,
sha_final,10982,11875,893,10,
.L29,11875,12029,154,8,
.L30,12029,12477,448,9,
sha_stream,12477,12756,279,9,
.LPIC2,12756,12949,193,8,
.L33,12949,13106,157,8,
.L32,13106,13587,481,9,
.L34,13587,13673,86,7,
.L36,13673,13689,16,4,
.L35,13689,13825,136,8,
.LC0,13825,13997,172,8,
sha_print,13997,14407,410,9,
.LPIC3,14407,14509,102,7,
.L39,14509,14525,16,4,
.L38,14525,14531,59,6,
end,end,end,end,


LineNum,inLabel,command,JumpToLabel,jumpToAd,start_row_counter,
Label,StartPoint,EndPoint,Size,log_2,
empty,1,363,362,9,
sha_transform,363,559,196,8,
.LPIC0,559,697,138,8,
.L3,697,981,284,9,
.L2,981,1089,108,7,
.L5,1089,1653,564,10,
.L4,1653,2158,505,9,
.L7,2158,3035,877,10,
.L6,3035,3143,108,7,
.L9,3143,3959,816,10,
.L8,3959,4068,109,7,
.L11,4068,4981,913,10,
.L10,4981,5092,111,7,
.L13,5092,5909,817,10,
.L12,5909,6810,901,10,
.L14,6810,6877,67,7,
.L16,6877,6893,16,4,
.L15,6893,7102,209,8,
byte_reverse,7102,7292,190,8,
.LPIC1,7292,7500,208,8,
.L19,7500,8261,761,10,
.L18,8261,8441,180,8,
.L20,8441,8504,63,6,
.L22,8504,8520,16,4,
.L21,8520,8741,221,8,
sha_init,8741,9583,842,10,
sha_update,9583,10022,439,9,
.L25,10022,10291,269,9,
.L27,10291,10629,338,9,
.L26,10629,10982,353,9,
sha_final,10982,11875,893,10,
.L29,11875,12029,154,8,
.L30,12029,12477,448,9,
sha_stream,12477,12756,279,9,
.LPIC2,12756,12949,193,8,
.L33,12949,13106,157,8,
.L32,13106,13587,481,9,
.L34,13587,13673,86,7,
.L36,13673,13689,16,4,
.L35,13689,13825,136,8,
.LC0,13825,13997,172,8,
sha_print,13997,14407,410,9,
.LPIC3,14407,14509,102,7,
.L39,14509,14525,16,4,
.L38,14525,14531,59,6,
end,end,end,end,


LineNum,inLabel,command,JumpToLabel,jumpToAd,start_row_counter,
Label,StartPoint,EndPoint,Size,log_2,
empty,1,363,362,9,
sha_transform,363,559,196,8,
.LPIC0,559,697,138,8,
.L3,697,981,284,9,
.L2,981,1089,108,7,
.L5,1089,1653,564,10,
.L4,1653,2158,505,9,
.L7,2158,3035,877,10,
.L6,3035,3143,108,7,
.L9,3143,3959,816,10,
.L8,3959,4068,109,7,
.L11,4068,4981,913,10,
.L10,4981,5092,111,7,
.L13,5092,5909,817,10,
.L12,5909,6810,901,10,
.L14,6810,6877,67,7,
.L16,6877,6893,16,4,
.L15,6893,7102,209,8,
byte_reverse,7102,7292,190,8,
.LPIC1,7292,7500,208,8,
.L19,7500,8261,761,10,
.L18,8261,8441,180,8,
.L20,8441,8504,63,6,
.L22,8504,8520,16,4,
.L21,8520,8741,221,8,
sha_init,8741,9583,842,10,
sha_update,9583,10022,439,9,
.L25,10022,10291,269,9,
.L27,10291,10629,338,9,
.L26,10629,10982,353,9,
sha_final,10982,11875,893,10,
.L29,11875,12029,154,8,
.L30,12029,12477,448,9,
sha_stream,12477,12756,279,9,
.LPIC2,12756,12949,193,8,
.L33,12949,13106,157,8,
.L32,13106,13587,481,9,
.L34,13587,13673,86,7,
.L36,13673,13689,16,4,
.L35,13689,13825,136,8,
.LC0,13825,13997,172,8,
sha_print,13997,14407,410,9,
.LPIC3,14407,14509,102,7,
.L39,14509,14525,16,4,
.L38,14525,14531,59,6,
end,end,end,end,


LineNum,inLabel,command,JumpToLabel,jumpToAd,start_row_counter,
Label,StartPoint,EndPoint,Size,log_2,
empty,1,363,362,9,
sha_transform,363,559,196,8,
.LPIC0,559,697,138,8,
.L3,697,981,284,9,
.L2,981,1089,108,7,
.L5,1089,1653,564,10,
.L4,1653,2158,505,9,
.L7,2158,3035,877,10,
.L6,3035,3143,108,7,
.L9,3143,3959,816,10,
.L8,3959,4068,109,7,
.L11,4068,4981,913,10,
.L10,4981,5092,111,7,
.L13,5092,5909,817,10,
.L12,5909,6810,901,10,
.L14,6810,6877,67,7,
.L16,6877,6893,16,4,
.L15,6893,7102,209,8,
byte_reverse,7102,7292,190,8,
.LPIC1,7292,7500,208,8,
.L19,7500,8261,761,10,
.L18,8261,8441,180,8,
.L20,8441,8504,63,6,
.L22,8504,8520,16,4,
.L21,8520,8741,221,8,
sha_init,8741,9583,842,10,
sha_update,9583,10022,439,9,
.L25,10022,10291,269,9,
.L27,10291,10629,338,9,
.L26,10629,10982,353,9,
sha_final,10982,11875,893,10,
.L29,11875,12029,154,8,
.L30,12029,12477,448,9,
sha_stream,12477,12756,279,9,
.LPIC2,12756,12949,193,8,
.L33,12949,13106,157,8,
.L32,13106,13587,481,9,
.L34,13587,13673,86,7,
.L36,13673,13689,16,4,
.L35,13689,13825,136,8,
.LC0,13825,13997,172,8,
sha_print,13997,14407,410,9,
.LPIC3,14407,14509,102,7,
.L39,14509,14525,16,4,
.L38,14525,14531,59,6,
end,end,end,end,


LineNum,inLabel,command,JumpToLabel,jumpToAd,start_row_counter,
Label,StartPoint,EndPoint,Size,log_2,
empty,1,363,362,9,
sha_transform,363,559,196,8,
.LPIC0,559,697,138,8,
.L3,697,981,284,9,
.L2,981,1089,108,7,
.L5,1089,1653,564,10,
.L4,1653,2158,505,9,
.L7,2158,3035,877,10,
.L6,3035,3143,108,7,
.L9,3143,3959,816,10,
.L8,3959,4068,109,7,
.L11,4068,4981,913,10,
.L10,4981,5092,111,7,
.L13,5092,5909,817,10,
.L12,5909,6810,901,10,
.L14,6810,6877,67,7,
.L16,6877,6893,16,4,
.L15,6893,7102,209,8,
byte_reverse,7102,7292,190,8,
.LPIC1,7292,7500,208,8,
.L19,7500,8261,761,10,
.L18,8261,8441,180,8,
.L20,8441,8504,63,6,
.L22,8504,8520,16,4,
.L21,8520,8741,221,8,
sha_init,8741,9583,842,10,
sha_update,9583,10022,439,9,
.L25,10022,10291,269,9,
.L27,10291,10629,338,9,
.L26,10629,10982,353,9,
sha_final,10982,11875,893,10,
.L29,11875,12029,154,8,
.L30,12029,12477,448,9,
sha_stream,12477,12756,279,9,
.LPIC2,12756,12949,193,8,
.L33,12949,13106,157,8,
.L32,13106,13587,481,9,
.L34,13587,13673,86,7,
.L36,13673,13689,16,4,
.L35,13689,13825,136,8,
.LC0,13825,13997,172,8,
sha_print,13997,14407,410,9,
.LPIC3,14407,14509,102,7,
.L39,14509,14525,16,4,
.L38,14525,14531,59,6,
end,end,end,end,


LineNum,inLabel,command,JumpToLabel,jumpToAd,start_row_counter,
Label,StartPoint,EndPoint,Size,log_2,
empty,1,363,362,9,
sha_transform,363,559,196,8,
.LPIC0,559,697,138,8,
.L3,697,981,284,9,
.L2,981,1089,108,7,
.L5,1089,1653,564,10,
.L4,1653,2158,505,9,
.L7,2158,3035,877,10,
.L6,3035,3143,108,7,
.L9,3143,3959,816,10,
.L8,3959,4068,109,7,
.L11,4068,4981,913,10,
.L10,4981,5092,111,7,
.L13,5092,5909,817,10,
.L12,5909,6810,901,10,
.L14,6810,6877,67,7,
.L16,6877,6893,16,4,
.L15,6893,7102,209,8,
byte_reverse,7102,7292,190,8,
.LPIC1,7292,7500,208,8,
.L19,7500,8261,761,10,
.L18,8261,8441,180,8,
.L20,8441,8504,63,6,
.L22,8504,8520,16,4,
.L21,8520,8741,221,8,
sha_init,8741,9583,842,10,
sha_update,9583,10022,439,9,
.L25,10022,10291,269,9,
.L27,10291,10629,338,9,
.L26,10629,10982,353,9,
sha_final,10982,11875,893,10,
.L29,11875,12029,154,8,
.L30,12029,12477,448,9,
sha_stream,12477,12756,279,9,
.LPIC2,12756,12949,193,8,
.L33,12949,13106,157,8,
.L32,13106,13587,481,9,
.L34,13587,13673,86,7,
.L36,13673,13689,16,4,
.L35,13689,13825,136,8,
.LC0,13825,13997,172,8,
sha_print,13997,14407,410,9,
.LPIC3,14407,14509,102,7,
.L39,14509,14525,16,4,
.L38,14525,14531,59,6,
end,end,end,end,


LineNum,inLabel,command,JumpToLabel,jumpToAd,start_row_counter,
Label,StartPoint,EndPoint,Size,log_2,
empty,1,363,362,9,
sha_transform,363,559,196,8,
.LPIC0,559,697,138,8,
.L3,697,981,284,9,
.L2,981,1089,108,7,
.L5,1089,1653,564,10,
.L4,1653,2158,505,9,
.L7,2158,3035,877,10,
.L6,3035,3143,108,7,
.L9,3143,3959,816,10,
.L8,3959,4068,109,7,
.L11,4068,4981,913,10,
.L10,4981,5092,111,7,
.L13,5092,5909,817,10,
.L12,5909,6810,901,10,
.L14,6810,6877,67,7,
.L16,6877,6893,16,4,
.L15,6893,7102,209,8,
byte_reverse,7102,7292,190,8,
.LPIC1,7292,7500,208,8,
.L19,7500,8261,761,10,
.L18,8261,8441,180,8,
.L20,8441,8504,63,6,
.L22,8504,8520,16,4,
.L21,8520,8741,221,8,
sha_init,8741,9583,842,10,
sha_update,9583,10022,439,9,
.L25,10022,10291,269,9,
.L27,10291,10629,338,9,
.L26,10629,10982,353,9,
sha_final,10982,11875,893,10,
.L29,11875,12029,154,8,
.L30,12029,12477,448,9,
sha_stream,12477,12756,279,9,
.LPIC2,12756,12949,193,8,
.L33,12949,13106,157,8,
.L32,13106,13587,481,9,
.L34,13587,13673,86,7,
.L36,13673,13689,16,4,
.L35,13689,13825,136,8,
.LC0,13825,13997,172,8,
sha_print,13997,14407,410,9,
.LPIC3,14407,14509,102,7,
.L39,14509,14525,16,4,
.L38,14525,14531,59,6,
end,end,end,end,


LineNum,inLabel,command,JumpToLabel,jumpToAd,start_row_counter,
Label,StartPoint,EndPoint,Size,log_2,
empty,1,363,362,9,
sha_transform,363,559,196,8,
.LPIC0,559,697,138,8,
.L3,697,981,284,9,
.L2,981,1089,108,7,
.L5,1089,1653,564,10,
.L4,1653,2158,505,9,
.L7,2158,3035,877,10,
.L6,3035,3143,108,7,
.L9,3143,3959,816,10,
.L8,3959,4068,109,7,
.L11,4068,4981,913,10,
.L10,4981,5092,111,7,
.L13,5092,5909,817,10,
.L12,5909,6810,901,10,
.L14,6810,6877,67,7,
.L16,6877,6893,16,4,
.L15,6893,7102,209,8,
byte_reverse,7102,7292,190,8,
.LPIC1,7292,7500,208,8,
.L19,7500,8261,761,10,
.L18,8261,8441,180,8,
.L20,8441,8504,63,6,
.L22,8504,8520,16,4,
.L21,8520,8741,221,8,
sha_init,8741,9583,842,10,
sha_update,9583,10022,439,9,
.L25,10022,10291,269,9,
.L27,10291,10629,338,9,
.L26,10629,10982,353,9,
sha_final,10982,11875,893,10,
.L29,11875,12029,154,8,
.L30,12029,12477,448,9,
sha_stream,12477,12756,279,9,
.LPIC2,12756,12949,193,8,
.L33,12949,13106,157,8,
.L32,13106,13587,481,9,
.L34,13587,13673,86,7,
.L36,13673,13689,16,4,
.L35,13689,13825,136,8,
.LC0,13825,13997,172,8,
sha_print,13997,14407,410,9,
.LPIC3,14407,14509,102,7,
.L39,14509,14525,16,4,
.L38,14525,14531,59,6,
end,end,end,end,


LineNum,inLabel,command,JumpToLabel,jumpToAd,start_row_counter,
Label,StartPoint,EndPoint,Size,log_2,
empty,1,363,362,9,
sha_transform,363,559,196,8,
.LPIC0,559,697,138,8,
.L3,697,981,284,9,
.L2,981,1089,108,7,
.L5,1089,1653,564,10,
.L4,1653,2158,505,9,
.L7,2158,3035,877,10,
.L6,3035,3143,108,7,
.L9,3143,3959,816,10,
.L8,3959,4068,109,7,
.L11,4068,4981,913,10,
.L10,4981,5092,111,7,
.L13,5092,5909,817,10,
.L12,5909,6810,901,10,
.L14,6810,6877,67,7,
.L16,6877,6893,16,4,
.L15,6893,7102,209,8,
byte_reverse,7102,7292,190,8,
.LPIC1,7292,7500,208,8,
.L19,7500,8261,761,10,
.L18,8261,8441,180,8,
.L20,8441,8504,63,6,
.L22,8504,8520,16,4,
.L21,8520,8741,221,8,
sha_init,8741,9583,842,10,
sha_update,9583,10022,439,9,
.L25,10022,10291,269,9,
.L27,10291,10629,338,9,
.L26,10629,10982,353,9,
sha_final,10982,11875,893,10,
.L29,11875,12029,154,8,
.L30,12029,12477,448,9,
sha_stream,12477,12756,279,9,
.LPIC2,12756,12949,193,8,
.L33,12949,13106,157,8,
.L32,13106,13587,481,9,
.L34,13587,13673,86,7,
.L36,13673,13689,16,4,
.L35,13689,13825,136,8,
.LC0,13825,13997,172,8,
sha_print,13997,14407,410,9,
.LPIC3,14407,14509,102,7,
.L39,14509,14525,16,4,
.L38,14525,14531,59,6,
end,end,end,end,


LineNum,inLabel,command,JumpToLabel,jumpToAd,start_row_counter,
Label,StartPoint,EndPoint,Size,log_2,
empty,1,363,362,9,
sha_transform,363,559,196,8,
.LPIC0,559,697,138,8,
.L3,697,981,284,9,
.L2,981,1089,108,7,
.L5,1089,1653,564,10,
.L4,1653,2158,505,9,
.L7,2158,3035,877,10,
.L6,3035,3143,108,7,
.L9,3143,3959,816,10,
.L8,3959,4068,109,7,
.L11,4068,4981,913,10,
.L10,4981,5092,111,7,
.L13,5092,5909,817,10,
.L12,5909,6810,901,10,
.L14,6810,6877,67,7,
.L16,6877,6893,16,4,
.L15,6893,7102,209,8,
byte_reverse,7102,7292,190,8,
.LPIC1,7292,7500,208,8,
.L19,7500,8261,761,10,
.L18,8261,8441,180,8,
.L20,8441,8504,63,6,
.L22,8504,8520,16,4,
.L21,8520,8741,221,8,
sha_init,8741,9583,842,10,
sha_update,9583,10022,439,9,
.L25,10022,10291,269,9,
.L27,10291,10629,338,9,
.L26,10629,10982,353,9,
sha_final,10982,11875,893,10,
.L29,11875,12029,154,8,
.L30,12029,12477,448,9,
sha_stream,12477,12756,279,9,
.LPIC2,12756,12949,193,8,
.L33,12949,13106,157,8,
.L32,13106,13587,481,9,
.L34,13587,13673,86,7,
.L36,13673,13689,16,4,
.L35,13689,13825,136,8,
.LC0,13825,13997,172,8,
sha_print,13997,14407,410,9,
.LPIC3,14407,14509,102,7,
.L39,14509,14525,16,4,
.L38,14525,14531,59,6,
end,end,end,end,


LineNum,inLabel,command,JumpToLabel,jumpToAd,start_row_counter,
Label,StartPoint,EndPoint,Size,log_2,
empty,1,363,362,9,
sha_transform,363,559,196,8,
.LPIC0,559,697,138,8,
.L3,697,981,284,9,
.L2,981,1089,108,7,
.L5,1089,1653,564,10,
.L4,1653,2158,505,9,
.L7,2158,3035,877,10,
.L6,3035,3143,108,7,
.L9,3143,3959,816,10,
.L8,3959,4068,109,7,
.L11,4068,4981,913,10,
.L10,4981,5092,111,7,
.L13,5092,5909,817,10,
.L12,5909,6810,901,10,
.L14,6810,6877,67,7,
.L16,6877,6893,16,4,
.L15,6893,7102,209,8,
byte_reverse,7102,7292,190,8,
.LPIC1,7292,7500,208,8,
.L19,7500,8261,761,10,
.L18,8261,8441,180,8,
.L20,8441,8504,63,6,
.L22,8504,8520,16,4,
.L21,8520,8741,221,8,
sha_init,8741,9583,842,10,
sha_update,9583,10022,439,9,
.L25,10022,10291,269,9,
.L27,10291,10629,338,9,
.L26,10629,10982,353,9,
sha_final,10982,11875,893,10,
.L29,11875,12029,154,8,
.L30,12029,12477,448,9,
sha_stream,12477,12756,279,9,
.LPIC2,12756,12949,193,8,
.L33,12949,13106,157,8,
.L32,13106,13587,481,9,
.L34,13587,13673,86,7,
.L36,13673,13689,16,4,
.L35,13689,13825,136,8,
.LC0,13825,13997,172,8,
sha_print,13997,14407,410,9,
.LPIC3,14407,14509,102,7,
.L39,14509,14525,16,4,
.L38,14525,14531,59,6,
end,end,end,end,


LineNum,inLabel,command,JumpToLabel,jumpToAd,start_row_counter,
Label,StartPoint,EndPoint,Size,log_2,
empty,1,363,362,9,
sha_transform,363,559,196,8,
.LPIC0,559,697,138,8,
.L3,697,981,284,9,
.L2,981,1089,108,7,
.L5,1089,1653,564,10,
.L4,1653,2158,505,9,
.L7,2158,3035,877,10,
.L6,3035,3143,108,7,
.L9,3143,3959,816,10,
.L8,3959,4068,109,7,
.L11,4068,4981,913,10,
.L10,4981,5092,111,7,
.L13,5092,5909,817,10,
.L12,5909,6810,901,10,
.L14,6810,6877,67,7,
.L16,6877,6893,16,4,
.L15,6893,7102,209,8,
byte_reverse,7102,7292,190,8,
.LPIC1,7292,7500,208,8,
.L19,7500,8261,761,10,
.L18,8261,8441,180,8,
.L20,8441,8504,63,6,
.L22,8504,8520,16,4,
.L21,8520,8741,221,8,
sha_init,8741,9583,842,10,
sha_update,9583,10022,439,9,
.L25,10022,10291,269,9,
.L27,10291,10629,338,9,
.L26,10629,10982,353,9,
sha_final,10982,11875,893,10,
.L29,11875,12029,154,8,
.L30,12029,12477,448,9,
sha_stream,12477,12756,279,9,
.LPIC2,12756,12949,193,8,
.L33,12949,13106,157,8,
.L32,13106,13587,481,9,
.L34,13587,13673,86,7,
.L36,13673,13689,16,4,
.L35,13689,13825,136,8,
.LC0,13825,13997,172,8,
sha_print,13997,14407,410,9,
.LPIC3,14407,14509,102,7,
.L39,14509,14525,16,4,
.L38,14525,14531,59,6,
end,end,end,end,


LineNum,inLabel,command,JumpToLabel,jumpToAd,start_row_counter,
Label,StartPoint,EndPoint,Size,log_2,
empty,1,363,362,9,
sha_transform,363,559,196,8,
.LPIC0,559,697,138,8,
.L3,697,981,284,9,
.L2,981,1089,108,7,
.L5,1089,1653,564,10,
.L4,1653,2158,505,9,
.L7,2158,3035,877,10,
.L6,3035,3143,108,7,
.L9,3143,3959,816,10,
.L8,3959,4068,109,7,
.L11,4068,4981,913,10,
.L10,4981,5092,111,7,
.L13,5092,5909,817,10,
.L12,5909,6810,901,10,
.L14,6810,6877,67,7,
.L16,6877,6893,16,4,
.L15,6893,7102,209,8,
byte_reverse,7102,7292,190,8,
.LPIC1,7292,7500,208,8,
.L19,7500,8261,761,10,
.L18,8261,8441,180,8,
.L20,8441,8504,63,6,
.L22,8504,8520,16,4,
.L21,8520,8741,221,8,
sha_init,8741,9583,842,10,
sha_update,9583,10022,439,9,
.L25,10022,10291,269,9,
.L27,10291,10629,338,9,
.L26,10629,10982,353,9,
sha_final,10982,11875,893,10,
.L29,11875,12029,154,8,
.L30,12029,12477,448,9,
sha_stream,12477,12756,279,9,
.LPIC2,12756,12949,193,8,
.L33,12949,13106,157,8,
.L32,13106,13587,481,9,
.L34,13587,13673,86,7,
.L36,13673,13689,16,4,
.L35,13689,13825,136,8,
.LC0,13825,13997,172,8,
sha_print,13997,14407,410,9,
.LPIC3,14407,14509,102,7,
.L39,14509,14525,16,4,
.L38,14525,14531,59,6,
end,end,end,end,


LineNum,inLabel,command,JumpToLabel,jumpToAd,start_row_counter,
Label,StartPoint,EndPoint,Size,log_2,
empty,1,363,362,9,
sha_transform,363,559,196,8,
.LPIC0,559,697,138,8,
.L3,697,981,284,9,
.L2,981,1089,108,7,
.L5,1089,1653,564,10,
.L4,1653,2158,505,9,
.L7,2158,3035,877,10,
.L6,3035,3143,108,7,
.L9,3143,3959,816,10,
.L8,3959,4068,109,7,
.L11,4068,4981,913,10,
.L10,4981,5092,111,7,
.L13,5092,5909,817,10,
.L12,5909,6810,901,10,
.L14,6810,6877,67,7,
.L16,6877,6893,16,4,
.L15,6893,7102,209,8,
byte_reverse,7102,7292,190,8,
.LPIC1,7292,7500,208,8,
.L19,7500,8261,761,10,
.L18,8261,8441,180,8,
.L20,8441,8504,63,6,
.L22,8504,8520,16,4,
.L21,8520,8741,221,8,
sha_init,8741,9583,842,10,
sha_update,9583,10022,439,9,
.L25,10022,10291,269,9,
.L27,10291,10629,338,9,
.L26,10629,10982,353,9,
sha_final,10982,11875,893,10,
.L29,11875,12029,154,8,
.L30,12029,12477,448,9,
sha_stream,12477,12756,279,9,
.LPIC2,12756,12949,193,8,
.L33,12949,13106,157,8,
.L32,13106,13587,481,9,
.L34,13587,13673,86,7,
.L36,13673,13689,16,4,
.L35,13689,13825,136,8,
.LC0,13825,13997,172,8,
sha_print,13997,14407,410,9,
.LPIC3,14407,14509,102,7,
.L39,14509,14525,16,4,
.L38,14525,14531,59,6,
end,end,end,end,


LineNum,inLabel,command,JumpToLabel,jumpToAd,start_row_counter,
Label,StartPoint,EndPoint,Size,log_2,
empty,1,363,362,9,
sha_transform,363,559,196,8,
.LPIC0,559,697,138,8,
.L3,697,981,284,9,
.L2,981,1089,108,7,
.L5,1089,1653,564,10,
.L4,1653,2158,505,9,
.L7,2158,3035,877,10,
.L6,3035,3143,108,7,
.L9,3143,3959,816,10,
.L8,3959,4068,109,7,
.L11,4068,4981,913,10,
.L10,4981,5092,111,7,
.L13,5092,5909,817,10,
.L12,5909,6810,901,10,
.L14,6810,6877,67,7,
.L16,6877,6893,16,4,
.L15,6893,7102,209,8,
byte_reverse,7102,7292,190,8,
.LPIC1,7292,7500,208,8,
.L19,7500,8261,761,10,
.L18,8261,8441,180,8,
.L20,8441,8504,63,6,
.L22,8504,8520,16,4,
.L21,8520,8741,221,8,
sha_init,8741,9583,842,10,
sha_update,9583,10022,439,9,
.L25,10022,10291,269,9,
.L27,10291,10629,338,9,
.L26,10629,10982,353,9,
sha_final,10982,11875,893,10,
.L29,11875,12029,154,8,
.L30,12029,12477,448,9,
sha_stream,12477,12756,279,9,
.LPIC2,12756,12949,193,8,
.L33,12949,13106,157,8,
.L32,13106,13587,481,9,
.L34,13587,13673,86,7,
.L36,13673,13689,16,4,
.L35,13689,13825,136,8,
.LC0,13825,13997,172,8,
sha_print,13997,14407,410,9,
.LPIC3,14407,14509,102,7,
.L39,14509,14525,16,4,
.L38,14525,14531,59,6,
end,end,end,end,


LineNum,inLabel,command,JumpToLabel,jumpToAd,start_row_counter,
Label,StartPoint,EndPoint,Size,log_2,
empty,1,363,362,9,
sha_transform,363,559,196,8,
.LPIC0,559,697,138,8,
.L3,697,981,284,9,
.L2,981,1089,108,7,
.L5,1089,1653,564,10,
.L4,1653,2158,505,9,
.L7,2158,3035,877,10,
.L6,3035,3143,108,7,
.L9,3143,3959,816,10,
.L8,3959,4068,109,7,
.L11,4068,4981,913,10,
.L10,4981,5092,111,7,
.L13,5092,5909,817,10,
.L12,5909,6810,901,10,
.L14,6810,6877,67,7,
.L16,6877,6893,16,4,
.L15,6893,7102,209,8,
byte_reverse,7102,7292,190,8,
.LPIC1,7292,7500,208,8,
.L19,7500,8261,761,10,
.L18,8261,8441,180,8,
.L20,8441,8504,63,6,
.L22,8504,8520,16,4,
.L21,8520,8741,221,8,
sha_init,8741,9583,842,10,
sha_update,9583,10022,439,9,
.L25,10022,10291,269,9,
.L27,10291,10629,338,9,
.L26,10629,10982,353,9,
sha_final,10982,11875,893,10,
.L29,11875,12029,154,8,
.L30,12029,12477,448,9,
sha_stream,12477,12756,279,9,
.LPIC2,12756,12949,193,8,
.L33,12949,13106,157,8,
.L32,13106,13587,481,9,
.L34,13587,13673,86,7,
.L36,13673,13689,16,4,
.L35,13689,13825,136,8,
.LC0,13825,13997,172,8,
sha_print,13997,14407,410,9,
.LPIC3,14407,14509,102,7,
.L39,14509,14525,16,4,
.L38,14525,14531,59,6,
end,end,end,end,


LineNum,inLabel,command,JumpToLabel,jumpToAd,start_row_counter,
Label,StartPoint,EndPoint,Size,log_2,
empty,1,363,362,9,
sha_transform,363,559,196,8,
.LPIC0,559,697,138,8,
.L3,697,981,284,9,
.L2,981,1089,108,7,
.L5,1089,1653,564,10,
.L4,1653,2158,505,9,
.L7,2158,3035,877,10,
.L6,3035,3143,108,7,
.L9,3143,3959,816,10,
.L8,3959,4068,109,7,
.L11,4068,4981,913,10,
.L10,4981,5092,111,7,
.L13,5092,5909,817,10,
.L12,5909,6810,901,10,
.L14,6810,6877,67,7,
.L16,6877,6893,16,4,
.L15,6893,7102,209,8,
byte_reverse,7102,7292,190,8,
.LPIC1,7292,7500,208,8,
.L19,7500,8261,761,10,
.L18,8261,8441,180,8,
.L20,8441,8504,63,6,
.L22,8504,8520,16,4,
.L21,8520,8741,221,8,
sha_init,8741,9583,842,10,
sha_update,9583,10022,439,9,
.L25,10022,10291,269,9,
.L27,10291,10629,338,9,
.L26,10629,10982,353,9,
sha_final,10982,11875,893,10,
.L29,11875,12029,154,8,
.L30,12029,12477,448,9,
sha_stream,12477,12756,279,9,
.LPIC2,12756,12949,193,8,
.L33,12949,13106,157,8,
.L32,13106,13587,481,9,
.L34,13587,13673,86,7,
.L36,13673,13689,16,4,
.L35,13689,13825,136,8,
.LC0,13825,13997,172,8,
sha_print,13997,14407,410,9,
.LPIC3,14407,14509,102,7,
.L39,14509,14525,16,4,
.L38,14525,14531,59,6,
end,end,end,end,


LineNum,inLabel,command,JumpToLabel,jumpToAd,start_row_counter,
Label,StartPoint,EndPoint,Size,log_2,
empty,1,363,362,9,
sha_transform,363,559,196,8,
.LPIC0,559,697,138,8,
.L3,697,981,284,9,
.L2,981,1089,108,7,
.L5,1089,1653,564,10,
.L4,1653,2158,505,9,
.L7,2158,3035,877,10,
.L6,3035,3143,108,7,
.L9,3143,3959,816,10,
.L8,3959,4068,109,7,
.L11,4068,4981,913,10,
.L10,4981,5092,111,7,
.L13,5092,5909,817,10,
.L12,5909,6810,901,10,
.L14,6810,6877,67,7,
.L16,6877,6893,16,4,
.L15,6893,7102,209,8,
byte_reverse,7102,7292,190,8,
.LPIC1,7292,7500,208,8,
.L19,7500,8261,761,10,
.L18,8261,8441,180,8,
.L20,8441,8504,63,6,
.L22,8504,8520,16,4,
.L21,8520,8741,221,8,
sha_init,8741,9583,842,10,
sha_update,9583,10022,439,9,
.L25,10022,10291,269,9,
.L27,10291,10629,338,9,
.L26,10629,10982,353,9,
sha_final,10982,11875,893,10,
.L29,11875,12029,154,8,
.L30,12029,12477,448,9,
sha_stream,12477,12756,279,9,
.LPIC2,12756,12949,193,8,
.L33,12949,13106,157,8,
.L32,13106,13587,481,9,
.L34,13587,13673,86,7,
.L36,13673,13689,16,4,
.L35,13689,13825,136,8,
.LC0,13825,13997,172,8,
sha_print,13997,14407,410,9,
.LPIC3,14407,14509,102,7,
.L39,14509,14525,16,4,
.L38,14525,14531,59,6,
end,end,end,end,


LineNum,inLabel,command,JumpToLabel,jumpToAd,start_row_counter,
Label,StartPoint,EndPoint,Size,log_2,
empty,1,363,362,9,
sha_transform,363,559,196,8,
.LPIC0,559,697,138,8,
.L3,697,981,284,9,
.L2,981,1089,108,7,
.L5,1089,1653,564,10,
.L4,1653,2158,505,9,
.L7,2158,3035,877,10,
.L6,3035,3143,108,7,
.L9,3143,3959,816,10,
.L8,3959,4068,109,7,
.L11,4068,4981,913,10,
.L10,4981,5092,111,7,
.L13,5092,5909,817,10,
.L12,5909,6810,901,10,
.L14,6810,6877,67,7,
.L16,6877,6893,16,4,
.L15,6893,7102,209,8,
byte_reverse,7102,7292,190,8,
.LPIC1,7292,7500,208,8,
.L19,7500,8261,761,10,
.L18,8261,8441,180,8,
.L20,8441,8504,63,6,
.L22,8504,8520,16,4,
.L21,8520,8741,221,8,
sha_init,8741,9583,842,10,
sha_update,9583,10022,439,9,
.L25,10022,10291,269,9,
.L27,10291,10629,338,9,
.L26,10629,10982,353,9,
sha_final,10982,11875,893,10,
.L29,11875,12029,154,8,
.L30,12029,12477,448,9,
sha_stream,12477,12756,279,9,
.LPIC2,12756,12949,193,8,
.L33,12949,13106,157,8,
.L32,13106,13587,481,9,
.L34,13587,13673,86,7,
.L36,13673,13689,16,4,
.L35,13689,13825,136,8,
.LC0,13825,13997,172,8,
sha_print,13997,14407,410,9,
.LPIC3,14407,14509,102,7,
.L39,14509,14525,16,4,
.L38,14525,14531,59,6,
end,end,end,end,


LineNum,inLabel,command,JumpToLabel,jumpToAd,start_row_counter,
Label,StartPoint,EndPoint,Size,log_2,
empty,1,363,362,9,
sha_transform,363,559,196,8,
.LPIC0,559,697,138,8,
.L3,697,981,284,9,
.L2,981,1089,108,7,
.L5,1089,1653,564,10,
.L4,1653,2158,505,9,
.L7,2158,3035,877,10,
.L6,3035,3143,108,7,
.L9,3143,3959,816,10,
.L8,3959,4068,109,7,
.L11,4068,4981,913,10,
.L10,4981,5092,111,7,
.L13,5092,5909,817,10,
.L12,5909,6810,901,10,
.L14,6810,6877,67,7,
.L16,6877,6893,16,4,
.L15,6893,7102,209,8,
byte_reverse,7102,7292,190,8,
.LPIC1,7292,7500,208,8,
.L19,7500,8261,761,10,
.L18,8261,8441,180,8,
.L20,8441,8504,63,6,
.L22,8504,8520,16,4,
.L21,8520,8741,221,8,
sha_init,8741,9583,842,10,
sha_update,9583,10022,439,9,
.L25,10022,10291,269,9,
.L27,10291,10629,338,9,
.L26,10629,10982,353,9,
sha_final,10982,11875,893,10,
.L29,11875,12029,154,8,
.L30,12029,12477,448,9,
sha_stream,12477,12756,279,9,
.LPIC2,12756,12949,193,8,
.L33,12949,13106,157,8,
.L32,13106,13587,481,9,
.L34,13587,13673,86,7,
.L36,13673,13689,16,4,
.L35,13689,13825,136,8,
.LC0,13825,13997,172,8,
sha_print,13997,14407,410,9,
.LPIC3,14407,14509,102,7,
.L39,14509,14525,16,4,
.L38,14525,14531,59,6,
end,end,end,end,


LineNum,inLabel,command,JumpToLabel,jumpToAd,start_row_counter,
Label,StartPoint,EndPoint,Size,log_2,
empty,1,363,362,9,
sha_transform,363,559,196,8,
.LPIC0,559,697,138,8,
.L3,697,981,284,9,
.L2,981,1089,108,7,
.L5,1089,1653,564,10,
.L4,1653,2158,505,9,
.L7,2158,3035,877,10,
.L6,3035,3143,108,7,
.L9,3143,3959,816,10,
.L8,3959,4068,109,7,
.L11,4068,4981,913,10,
.L10,4981,5092,111,7,
.L13,5092,5909,817,10,
.L12,5909,6810,901,10,
.L14,6810,6877,67,7,
.L16,6877,6893,16,4,
.L15,6893,7102,209,8,
byte_reverse,7102,7292,190,8,
.LPIC1,7292,7500,208,8,
.L19,7500,8261,761,10,
.L18,8261,8441,180,8,
.L20,8441,8504,63,6,
.L22,8504,8520,16,4,
.L21,8520,8741,221,8,
sha_init,8741,9583,842,10,
sha_update,9583,10022,439,9,
.L25,10022,10291,269,9,
.L27,10291,10629,338,9,
.L26,10629,10982,353,9,
sha_final,10982,11875,893,10,
.L29,11875,12029,154,8,
.L30,12029,12477,448,9,
sha_stream,12477,12756,279,9,
.LPIC2,12756,12949,193,8,
.L33,12949,13106,157,8,
.L32,13106,13587,481,9,
.L34,13587,13673,86,7,
.L36,13673,13689,16,4,
.L35,13689,13825,136,8,
.LC0,13825,13997,172,8,
sha_print,13997,14407,410,9,
.LPIC3,14407,14509,102,7,
.L39,14509,14525,16,4,
.L38,14525,14531,59,6,
end,end,end,end,


LineNum,inLabel,command,JumpToLabel,jumpToAd,start_row_counter,
Label,StartPoint,EndPoint,Size,log_2,
empty,1,363,362,9,
sha_transform,363,559,196,8,
.LPIC0,559,697,138,8,
.L3,697,981,284,9,
.L2,981,1089,108,7,
.L5,1089,1653,564,10,
.L4,1653,2158,505,9,
.L7,2158,3035,877,10,
.L6,3035,3143,108,7,
.L9,3143,3959,816,10,
.L8,3959,4068,109,7,
.L11,4068,4981,913,10,
.L10,4981,5092,111,7,
.L13,5092,5909,817,10,
.L12,5909,6810,901,10,
.L14,6810,6877,67,7,
.L16,6877,6893,16,4,
.L15,6893,7102,209,8,
byte_reverse,7102,7292,190,8,
.LPIC1,7292,7500,208,8,
.L19,7500,8261,761,10,
.L18,8261,8441,180,8,
.L20,8441,8504,63,6,
.L22,8504,8520,16,4,
.L21,8520,8741,221,8,
sha_init,8741,9583,842,10,
sha_update,9583,10022,439,9,
.L25,10022,10291,269,9,
.L27,10291,10629,338,9,
.L26,10629,10982,353,9,
sha_final,10982,11875,893,10,
.L29,11875,12029,154,8,
.L30,12029,12477,448,9,
sha_stream,12477,12756,279,9,
.LPIC2,12756,12949,193,8,
.L33,12949,13106,157,8,
.L32,13106,13587,481,9,
.L34,13587,13673,86,7,
.L36,13673,13689,16,4,
.L35,13689,13825,136,8,
.LC0,13825,13997,172,8,
sha_print,13997,14407,410,9,
.LPIC3,14407,14509,102,7,
.L39,14509,14525,16,4,
.L38,14525,14531,59,6,
end,end,end,end,


LineNum,inLabel,command,JumpToLabel,jumpToAd,start_row_counter,
Label,StartPoint,EndPoint,Size,log_2,
empty,1,363,362,9,
sha_transform,363,559,196,8,
.LPIC0,559,697,138,8,
.L3,697,981,284,9,
.L2,981,1089,108,7,
.L5,1089,1653,564,10,
.L4,1653,2158,505,9,
.L7,2158,3035,877,10,
.L6,3035,3143,108,7,
.L9,3143,3959,816,10,
.L8,3959,4068,109,7,
.L11,4068,4981,913,10,
.L10,4981,5092,111,7,
.L13,5092,5909,817,10,
.L12,5909,6810,901,10,
.L14,6810,6877,67,7,
.L16,6877,6893,16,4,
.L15,6893,7102,209,8,
byte_reverse,7102,7292,190,8,
.LPIC1,7292,7500,208,8,
.L19,7500,8261,761,10,
.L18,8261,8441,180,8,
.L20,8441,8504,63,6,
.L22,8504,8520,16,4,
.L21,8520,8741,221,8,
sha_init,8741,9583,842,10,
sha_update,9583,10022,439,9,
.L25,10022,10291,269,9,
.L27,10291,10629,338,9,
.L26,10629,10982,353,9,
sha_final,10982,11875,893,10,
.L29,11875,12029,154,8,
.L30,12029,12477,448,9,
sha_stream,12477,12756,279,9,
.LPIC2,12756,12949,193,8,
.L33,12949,13106,157,8,
.L32,13106,13587,481,9,
.L34,13587,13673,86,7,
.L36,13673,13689,16,4,
.L35,13689,13825,136,8,
.LC0,13825,13997,172,8,
sha_print,13997,14407,410,9,
.LPIC3,14407,14509,102,7,
.L39,14509,14525,16,4,
.L38,14525,14531,59,6,
end,end,end,end,


LineNum,inLabel,command,JumpToLabel,jumpToAd,start_row_counter,
Label,StartPoint,EndPoint,Size,log_2,
empty,1,363,362,9,
sha_transform,363,559,196,8,
.LPIC0,559,697,138,8,
.L3,697,981,284,9,
.L2,981,1089,108,7,
.L5,1089,1653,564,10,
.L4,1653,2158,505,9,
.L7,2158,3035,877,10,
.L6,3035,3143,108,7,
.L9,3143,3959,816,10,
.L8,3959,4068,109,7,
.L11,4068,4981,913,10,
.L10,4981,5092,111,7,
.L13,5092,5909,817,10,
.L12,5909,6810,901,10,
.L14,6810,6877,67,7,
.L16,6877,6893,16,4,
.L15,6893,7102,209,8,
byte_reverse,7102,7292,190,8,
.LPIC1,7292,7500,208,8,
.L19,7500,8261,761,10,
.L18,8261,8441,180,8,
.L20,8441,8504,63,6,
.L22,8504,8520,16,4,
.L21,8520,8741,221,8,
sha_init,8741,9583,842,10,
sha_update,9583,10022,439,9,
.L25,10022,10291,269,9,
.L27,10291,10629,338,9,
.L26,10629,10982,353,9,
sha_final,10982,11875,893,10,
.L29,11875,12029,154,8,
.L30,12029,12477,448,9,
sha_stream,12477,12756,279,9,
.LPIC2,12756,12949,193,8,
.L33,12949,13106,157,8,
.L32,13106,13587,481,9,
.L34,13587,13673,86,7,
.L36,13673,13689,16,4,
.L35,13689,13825,136,8,
.LC0,13825,13997,172,8,
sha_print,13997,14407,410,9,
.LPIC3,14407,14509,102,7,
.L39,14509,14525,16,4,
.L38,14525,14531,59,6,
end,end,end,end,


LineNum,inLabel,command,JumpToLabel,jumpToAd,start_row_counter,
Label,StartPoint,EndPoint,Size,log_2,
empty,1,363,362,9,
sha_transform,363,559,196,8,
.LPIC0,559,697,138,8,
.L3,697,981,284,9,
.L2,981,1089,108,7,
.L5,1089,1653,564,10,
.L4,1653,2158,505,9,
.L7,2158,3035,877,10,
.L6,3035,3143,108,7,
.L9,3143,3959,816,10,
.L8,3959,4068,109,7,
.L11,4068,4981,913,10,
.L10,4981,5092,111,7,
.L13,5092,5909,817,10,
.L12,5909,6810,901,10,
.L14,6810,6877,67,7,
.L16,6877,6893,16,4,
.L15,6893,7102,209,8,
byte_reverse,7102,7292,190,8,
.LPIC1,7292,7500,208,8,
.L19,7500,8261,761,10,
.L18,8261,8441,180,8,
.L20,8441,8504,63,6,
.L22,8504,8520,16,4,
.L21,8520,8741,221,8,
sha_init,8741,9583,842,10,
sha_update,9583,10022,439,9,
.L25,10022,10291,269,9,
.L27,10291,10629,338,9,
.L26,10629,10982,353,9,
sha_final,10982,11875,893,10,
.L29,11875,12029,154,8,
.L30,12029,12477,448,9,
sha_stream,12477,12756,279,9,
.LPIC2,12756,12949,193,8,
.L33,12949,13106,157,8,
.L32,13106,13587,481,9,
.L34,13587,13673,86,7,
.L36,13673,13689,16,4,
.L35,13689,13825,136,8,
.LC0,13825,13997,172,8,
sha_print,13997,14407,410,9,
.LPIC3,14407,14509,102,7,
.L39,14509,14525,16,4,
.L38,14525,14531,59,6,
end,end,end,end,


LineNum,inLabel,command,JumpToLabel,jumpToAd,start_row_counter,
Label,StartPoint,EndPoint,Size,log_2,
empty,1,363,362,9,
sha_transform,363,559,196,8,
.LPIC0,559,697,138,8,
.L3,697,981,284,9,
.L2,981,1089,108,7,
.L5,1089,1653,564,10,
.L4,1653,2158,505,9,
.L7,2158,3035,877,10,
.L6,3035,3143,108,7,
.L9,3143,3959,816,10,
.L8,3959,4068,109,7,
.L11,4068,4981,913,10,
.L10,4981,5092,111,7,
.L13,5092,5909,817,10,
.L12,5909,6810,901,10,
.L14,6810,6877,67,7,
.L16,6877,6893,16,4,
.L15,6893,7102,209,8,
byte_reverse,7102,7292,190,8,
.LPIC1,7292,7500,208,8,
.L19,7500,8261,761,10,
.L18,8261,8441,180,8,
.L20,8441,8504,63,6,
.L22,8504,8520,16,4,
.L21,8520,8741,221,8,
sha_init,8741,9583,842,10,
sha_update,9583,10022,439,9,
.L25,10022,10291,269,9,
.L27,10291,10629,338,9,
.L26,10629,10982,353,9,
sha_final,10982,11875,893,10,
.L29,11875,12029,154,8,
.L30,12029,12477,448,9,
sha_stream,12477,12756,279,9,
.LPIC2,12756,12949,193,8,
.L33,12949,13106,157,8,
.L32,13106,13587,481,9,
.L34,13587,13673,86,7,
.L36,13673,13689,16,4,
.L35,13689,13825,136,8,
.LC0,13825,13997,172,8,
sha_print,13997,14407,410,9,
.LPIC3,14407,14509,102,7,
.L39,14509,14525,16,4,
.L38,14525,14531,59,6,
end,end,end,end,


LineNum,inLabel,command,JumpToLabel,jumpToAd,start_row_counter,
Label,StartPoint,EndPoint,Size,log_2,
empty,1,363,362,9,
sha_transform,363,559,196,8,
.LPIC0,559,697,138,8,
.L3,697,981,284,9,
.L2,981,1089,108,7,
.L5,1089,1653,564,10,
.L4,1653,2158,505,9,
.L7,2158,3035,877,10,
.L6,3035,3143,108,7,
.L9,3143,3959,816,10,
.L8,3959,4068,109,7,
.L11,4068,4981,913,10,
.L10,4981,5092,111,7,
.L13,5092,5909,817,10,
.L12,5909,6810,901,10,
.L14,6810,6877,67,7,
.L16,6877,6893,16,4,
.L15,6893,7102,209,8,
byte_reverse,7102,7292,190,8,
.LPIC1,7292,7500,208,8,
.L19,7500,8261,761,10,
.L18,8261,8441,180,8,
.L20,8441,8504,63,6,
.L22,8504,8520,16,4,
.L21,8520,8741,221,8,
sha_init,8741,9583,842,10,
sha_update,9583,10022,439,9,
.L25,10022,10291,269,9,
.L27,10291,10629,338,9,
.L26,10629,10982,353,9,
sha_final,10982,11875,893,10,
.L29,11875,12029,154,8,
.L30,12029,12477,448,9,
sha_stream,12477,12756,279,9,
.LPIC2,12756,12949,193,8,
.L33,12949,13106,157,8,
.L32,13106,13587,481,9,
.L34,13587,13673,86,7,
.L36,13673,13689,16,4,
.L35,13689,13825,136,8,
.LC0,13825,13997,172,8,
sha_print,13997,14407,410,9,
.LPIC3,14407,14509,102,7,
.L39,14509,14525,16,4,
.L38,14525,14531,59,6,
end,end,end,end,


LineNum,inLabel,command,JumpToLabel,jumpToAd,start_row_counter,
Label,StartPoint,EndPoint,Size,log_2,
empty,1,363,362,9,
sha_transform,363,559,196,8,
.LPIC0,559,697,138,8,
.L3,697,981,284,9,
.L2,981,1089,108,7,
.L5,1089,1653,564,10,
.L4,1653,2158,505,9,
.L7,2158,3035,877,10,
.L6,3035,3143,108,7,
.L9,3143,3959,816,10,
.L8,3959,4068,109,7,
.L11,4068,4981,913,10,
.L10,4981,5092,111,7,
.L13,5092,5909,817,10,
.L12,5909,6810,901,10,
.L14,6810,6877,67,7,
.L16,6877,6893,16,4,
.L15,6893,7102,209,8,
byte_reverse,7102,7292,190,8,
.LPIC1,7292,7500,208,8,
.L19,7500,8261,761,10,
.L18,8261,8441,180,8,
.L20,8441,8504,63,6,
.L22,8504,8520,16,4,
.L21,8520,8741,221,8,
sha_init,8741,9583,842,10,
sha_update,9583,10022,439,9,
.L25,10022,10291,269,9,
.L27,10291,10629,338,9,
.L26,10629,10982,353,9,
sha_final,10982,11875,893,10,
.L29,11875,12029,154,8,
.L30,12029,12477,448,9,
sha_stream,12477,12756,279,9,
.LPIC2,12756,12949,193,8,
.L33,12949,13106,157,8,
.L32,13106,13587,481,9,
.L34,13587,13673,86,7,
.L36,13673,13689,16,4,
.L35,13689,13825,136,8,
.LC0,13825,13997,172,8,
sha_print,13997,14407,410,9,
.LPIC3,14407,14509,102,7,
.L39,14509,14525,16,4,
.L38,14525,14531,59,6,
end,end,end,end,


LineNum,inLabel,command,JumpToLabel,jumpToAd,start_row_counter,
Label,StartPoint,EndPoint,Size,log_2,
empty,1,363,362,9,
sha_transform,363,559,196,8,
.LPIC0,559,697,138,8,
.L3,697,981,284,9,
.L2,981,1089,108,7,
.L5,1089,1653,564,10,
.L4,1653,2158,505,9,
.L7,2158,3035,877,10,
.L6,3035,3143,108,7,
.L9,3143,3959,816,10,
.L8,3959,4068,109,7,
.L11,4068,4981,913,10,
.L10,4981,5092,111,7,
.L13,5092,5909,817,10,
.L12,5909,6810,901,10,
.L14,6810,6877,67,7,
.L16,6877,6893,16,4,
.L15,6893,7102,209,8,
byte_reverse,7102,7292,190,8,
.LPIC1,7292,7500,208,8,
.L19,7500,8261,761,10,
.L18,8261,8441,180,8,
.L20,8441,8504,63,6,
.L22,8504,8520,16,4,
.L21,8520,8741,221,8,
sha_init,8741,9583,842,10,
sha_update,9583,10022,439,9,
.L25,10022,10291,269,9,
.L27,10291,10629,338,9,
.L26,10629,10982,353,9,
sha_final,10982,11875,893,10,
.L29,11875,12029,154,8,
.L30,12029,12477,448,9,
sha_stream,12477,12756,279,9,
.LPIC2,12756,12949,193,8,
.L33,12949,13106,157,8,
.L32,13106,13587,481,9,
.L34,13587,13673,86,7,
.L36,13673,13689,16,4,
.L35,13689,13825,136,8,
.LC0,13825,13997,172,8,
sha_print,13997,14407,410,9,
.LPIC3,14407,14509,102,7,
.L39,14509,14525,16,4,
.L38,14525,14531,59,6,
end,end,end,end,


LineNum,inLabel,command,JumpToLabel,jumpToAd,start_row_counter,
Label,StartPoint,EndPoint,Size,log_2,
empty,1,363,362,9,
sha_transform,363,559,196,8,
.LPIC0,559,697,138,8,
.L3,697,981,284,9,
.L2,981,1089,108,7,
.L5,1089,1653,564,10,
.L4,1653,2158,505,9,
.L7,2158,3035,877,10,
.L6,3035,3143,108,7,
.L9,3143,3959,816,10,
.L8,3959,4068,109,7,
.L11,4068,4981,913,10,
.L10,4981,5092,111,7,
.L13,5092,5909,817,10,
.L12,5909,6810,901,10,
.L14,6810,6877,67,7,
.L16,6877,6893,16,4,
.L15,6893,7102,209,8,
byte_reverse,7102,7292,190,8,
.LPIC1,7292,7500,208,8,
.L19,7500,8261,761,10,
.L18,8261,8441,180,8,
.L20,8441,8504,63,6,
.L22,8504,8520,16,4,
.L21,8520,8741,221,8,
sha_init,8741,9583,842,10,
sha_update,9583,10022,439,9,
.L25,10022,10291,269,9,
.L27,10291,10629,338,9,
.L26,10629,10982,353,9,
sha_final,10982,11875,893,10,
.L29,11875,12029,154,8,
.L30,12029,12477,448,9,
sha_stream,12477,12756,279,9,
.LPIC2,12756,12949,193,8,
.L33,12949,13106,157,8,
.L32,13106,13587,481,9,
.L34,13587,13673,86,7,
.L36,13673,13689,16,4,
.L35,13689,13825,136,8,
.LC0,13825,13997,172,8,
sha_print,13997,14407,410,9,
.LPIC3,14407,14509,102,7,
.L39,14509,14525,16,4,
.L38,14525,14531,59,6,
end,end,end,end,


LineNum,inLabel,command,JumpToLabel,jumpToAd,start_row_counter,
Label,StartPoint,EndPoint,Size,log_2,
empty,1,363,362,9,
sha_transform,363,559,196,8,
.LPIC0,559,697,138,8,
.L3,697,981,284,9,
.L2,981,1089,108,7,
.L5,1089,1653,564,10,
.L4,1653,2158,505,9,
.L7,2158,3035,877,10,
.L6,3035,3143,108,7,
.L9,3143,3959,816,10,
.L8,3959,4068,109,7,
.L11,4068,4981,913,10,
.L10,4981,5092,111,7,
.L13,5092,5909,817,10,
.L12,5909,6810,901,10,
.L14,6810,6877,67,7,
.L16,6877,6893,16,4,
.L15,6893,7102,209,8,
byte_reverse,7102,7292,190,8,
.LPIC1,7292,7500,208,8,
.L19,7500,8261,761,10,
.L18,8261,8441,180,8,
.L20,8441,8504,63,6,
.L22,8504,8520,16,4,
.L21,8520,8741,221,8,
sha_init,8741,9583,842,10,
sha_update,9583,10022,439,9,
.L25,10022,10291,269,9,
.L27,10291,10629,338,9,
.L26,10629,10982,353,9,
sha_final,10982,11875,893,10,
.L29,11875,12029,154,8,
.L30,12029,12477,448,9,
sha_stream,12477,12756,279,9,
.LPIC2,12756,12949,193,8,
.L33,12949,13106,157,8,
.L32,13106,13587,481,9,
.L34,13587,13673,86,7,
.L36,13673,13689,16,4,
.L35,13689,13825,136,8,
.LC0,13825,13997,172,8,
sha_print,13997,14407,410,9,
.LPIC3,14407,14509,102,7,
.L39,14509,14525,16,4,
.L38,14525,14531,59,6,
end,end,end,end,


LineNum,inLabel,command,JumpToLabel,jumpToAd,start_row_counter,
Label,StartPoint,EndPoint,Size,log_2,
empty,1,363,362,9,
sha_transform,363,559,196,8,
.LPIC0,559,697,138,8,
.L3,697,981,284,9,
.L2,981,1089,108,7,
.L5,1089,1653,564,10,
.L4,1653,2158,505,9,
.L7,2158,3035,877,10,
.L6,3035,3143,108,7,
.L9,3143,3959,816,10,
.L8,3959,4068,109,7,
.L11,4068,4981,913,10,
.L10,4981,5092,111,7,
.L13,5092,5909,817,10,
.L12,5909,6810,901,10,
.L14,6810,6877,67,7,
.L16,6877,6893,16,4,
.L15,6893,7102,209,8,
byte_reverse,7102,7292,190,8,
.LPIC1,7292,7500,208,8,
.L19,7500,8261,761,10,
.L18,8261,8441,180,8,
.L20,8441,8504,63,6,
.L22,8504,8520,16,4,
.L21,8520,8741,221,8,
sha_init,8741,9583,842,10,
sha_update,9583,10022,439,9,
.L25,10022,10291,269,9,
.L27,10291,10629,338,9,
.L26,10629,10982,353,9,
sha_final,10982,11875,893,10,
.L29,11875,12029,154,8,
.L30,12029,12477,448,9,
sha_stream,12477,12756,279,9,
.LPIC2,12756,12949,193,8,
.L33,12949,13106,157,8,
.L32,13106,13587,481,9,
.L34,13587,13673,86,7,
.L36,13673,13689,16,4,
.L35,13689,13825,136,8,
.LC0,13825,13997,172,8,
sha_print,13997,14407,410,9,
.LPIC3,14407,14509,102,7,
.L39,14509,14525,16,4,
.L38,14525,14531,59,6,
end,end,end,end,


LineNum,inLabel,command,JumpToLabel,jumpToAd,start_row_counter,
Label,StartPoint,EndPoint,Size,log_2,
empty,1,363,362,9,
sha_transform,363,559,196,8,
.LPIC0,559,697,138,8,
.L3,697,981,284,9,
.L2,981,1089,108,7,
.L5,1089,1653,564,10,
.L4,1653,2158,505,9,
.L7,2158,3035,877,10,
.L6,3035,3143,108,7,
.L9,3143,3959,816,10,
.L8,3959,4068,109,7,
.L11,4068,4981,913,10,
.L10,4981,5092,111,7,
.L13,5092,5909,817,10,
.L12,5909,6810,901,10,
.L14,6810,6877,67,7,
.L16,6877,6893,16,4,
.L15,6893,7102,209,8,
byte_reverse,7102,7292,190,8,
.LPIC1,7292,7500,208,8,
.L19,7500,8261,761,10,
.L18,8261,8441,180,8,
.L20,8441,8504,63,6,
.L22,8504,8520,16,4,
.L21,8520,8741,221,8,
sha_init,8741,9583,842,10,
sha_update,9583,10022,439,9,
.L25,10022,10291,269,9,
.L27,10291,10629,338,9,
.L26,10629,10982,353,9,
sha_final,10982,11875,893,10,
.L29,11875,12029,154,8,
.L30,12029,12477,448,9,
sha_stream,12477,12756,279,9,
.LPIC2,12756,12949,193,8,
.L33,12949,13106,157,8,
.L32,13106,13587,481,9,
.L34,13587,13673,86,7,
.L36,13673,13689,16,4,
.L35,13689,13825,136,8,
.LC0,13825,13997,172,8,
sha_print,13997,14407,410,9,
.LPIC3,14407,14509,102,7,
.L39,14509,14525,16,4,
.L38,14525,14531,59,6,
end,end,end,end,


LineNum,inLabel,command,JumpToLabel,jumpToAd,start_row_counter,
Label,StartPoint,EndPoint,Size,log_2,
empty,1,363,362,9,
sha_transform,363,559,196,8,
.LPIC0,559,697,138,8,
.L3,697,981,284,9,
.L2,981,1089,108,7,
.L5,1089,1653,564,10,
.L4,1653,2158,505,9,
.L7,2158,3035,877,10,
.L6,3035,3143,108,7,
.L9,3143,3959,816,10,
.L8,3959,4068,109,7,
.L11,4068,4981,913,10,
.L10,4981,5092,111,7,
.L13,5092,5909,817,10,
.L12,5909,6810,901,10,
.L14,6810,6877,67,7,
.L16,6877,6893,16,4,
.L15,6893,7102,209,8,
byte_reverse,7102,7292,190,8,
.LPIC1,7292,7500,208,8,
.L19,7500,8261,761,10,
.L18,8261,8441,180,8,
.L20,8441,8504,63,6,
.L22,8504,8520,16,4,
.L21,8520,8741,221,8,
sha_init,8741,9583,842,10,
sha_update,9583,10022,439,9,
.L25,10022,10291,269,9,
.L27,10291,10629,338,9,
.L26,10629,10982,353,9,
sha_final,10982,11875,893,10,
.L29,11875,12029,154,8,
.L30,12029,12477,448,9,
sha_stream,12477,12756,279,9,
.LPIC2,12756,12949,193,8,
.L33,12949,13106,157,8,
.L32,13106,13587,481,9,
.L34,13587,13673,86,7,
.L36,13673,13689,16,4,
.L35,13689,13825,136,8,
.LC0,13825,13997,172,8,
sha_print,13997,14407,410,9,
.LPIC3,14407,14509,102,7,
.L39,14509,14525,16,4,
.L38,14525,14531,59,6,
end,end,end,end,


LineNum,inLabel,command,JumpToLabel,jumpToAd,start_row_counter,
Label,StartPoint,EndPoint,Size,log_2,
empty,1,363,362,9,
sha_transform,363,559,196,8,
.LPIC0,559,697,138,8,
.L3,697,981,284,9,
.L2,981,1089,108,7,
.L5,1089,1653,564,10,
.L4,1653,2158,505,9,
.L7,2158,3035,877,10,
.L6,3035,3143,108,7,
.L9,3143,3959,816,10,
.L8,3959,4068,109,7,
.L11,4068,4981,913,10,
.L10,4981,5092,111,7,
.L13,5092,5909,817,10,
.L12,5909,6810,901,10,
.L14,6810,6877,67,7,
.L16,6877,6893,16,4,
.L15,6893,7102,209,8,
byte_reverse,7102,7292,190,8,
.LPIC1,7292,7500,208,8,
.L19,7500,8261,761,10,
.L18,8261,8441,180,8,
.L20,8441,8504,63,6,
.L22,8504,8520,16,4,
.L21,8520,8741,221,8,
sha_init,8741,9583,842,10,
sha_update,9583,10022,439,9,
.L25,10022,10291,269,9,
.L27,10291,10629,338,9,
.L26,10629,10982,353,9,
sha_final,10982,11875,893,10,
.L29,11875,12029,154,8,
.L30,12029,12477,448,9,
sha_stream,12477,12756,279,9,
.LPIC2,12756,12949,193,8,
.L33,12949,13106,157,8,
.L32,13106,13587,481,9,
.L34,13587,13673,86,7,
.L36,13673,13689,16,4,
.L35,13689,13825,136,8,
.LC0,13825,13997,172,8,
sha_print,13997,14407,410,9,
.LPIC3,14407,14509,102,7,
.L39,14509,14525,16,4,
.L38,14525,14531,59,6,
end,end,end,end,


LineNum,inLabel,command,JumpToLabel,jumpToAd,start_row_counter,
Label,StartPoint,EndPoint,Size,log_2,
empty,1,363,362,9,
sha_transform,363,559,196,8,
.LPIC0,559,697,138,8,
.L3,697,981,284,9,
.L2,981,1089,108,7,
.L5,1089,1653,564,10,
.L4,1653,2158,505,9,
.L7,2158,3035,877,10,
.L6,3035,3143,108,7,
.L9,3143,3959,816,10,
.L8,3959,4068,109,7,
.L11,4068,4981,913,10,
.L10,4981,5092,111,7,
.L13,5092,5909,817,10,
.L12,5909,6810,901,10,
.L14,6810,6877,67,7,
.L16,6877,6893,16,4,
.L15,6893,7102,209,8,
byte_reverse,7102,7292,190,8,
.LPIC1,7292,7500,208,8,
.L19,7500,8261,761,10,
.L18,8261,8441,180,8,
.L20,8441,8504,63,6,
.L22,8504,8520,16,4,
.L21,8520,8741,221,8,
sha_init,8741,9583,842,10,
sha_update,9583,10022,439,9,
.L25,10022,10291,269,9,
.L27,10291,10629,338,9,
.L26,10629,10982,353,9,
sha_final,10982,11875,893,10,
.L29,11875,12029,154,8,
.L30,12029,12477,448,9,
sha_stream,12477,12756,279,9,
.LPIC2,12756,12949,193,8,
.L33,12949,13106,157,8,
.L32,13106,13587,481,9,
.L34,13587,13673,86,7,
.L36,13673,13689,16,4,
.L35,13689,13825,136,8,
.LC0,13825,13997,172,8,
sha_print,13997,14407,410,9,
.LPIC3,14407,14509,102,7,
.L39,14509,14525,16,4,
.L38,14525,14531,59,6,
end,end,end,end,


LineNum,inLabel,command,JumpToLabel,jumpToAd,start_row_counter,
Label,StartPoint,EndPoint,Size,log_2,
empty,1,363,362,9,
sha_transform,363,559,196,8,
.LPIC0,559,697,138,8,
.L3,697,981,284,9,
.L2,981,1089,108,7,
.L5,1089,1653,564,10,
.L4,1653,2158,505,9,
.L7,2158,3035,877,10,
.L6,3035,3143,108,7,
.L9,3143,3959,816,10,
.L8,3959,4068,109,7,
.L11,4068,4981,913,10,
.L10,4981,5092,111,7,
.L13,5092,5909,817,10,
.L12,5909,6810,901,10,
.L14,6810,6877,67,7,
.L16,6877,6893,16,4,
.L15,6893,7102,209,8,
byte_reverse,7102,7292,190,8,
.LPIC1,7292,7500,208,8,
.L19,7500,8261,761,10,
.L18,8261,8441,180,8,
.L20,8441,8504,63,6,
.L22,8504,8520,16,4,
.L21,8520,8741,221,8,
sha_init,8741,9583,842,10,
sha_update,9583,10022,439,9,
.L25,10022,10291,269,9,
.L27,10291,10629,338,9,
.L26,10629,10982,353,9,
sha_final,10982,11875,893,10,
.L29,11875,12029,154,8,
.L30,12029,12477,448,9,
sha_stream,12477,12756,279,9,
.LPIC2,12756,12949,193,8,
.L33,12949,13106,157,8,
.L32,13106,13587,481,9,
.L34,13587,13673,86,7,
.L36,13673,13689,16,4,
.L35,13689,13825,136,8,
.LC0,13825,13997,172,8,
sha_print,13997,14407,410,9,
.LPIC3,14407,14509,102,7,
.L39,14509,14525,16,4,
.L38,14525,14531,59,6,
end,end,end,end,


LineNum,inLabel,command,JumpToLabel,jumpToAd,start_row_counter,
Label,StartPoint,EndPoint,Size,log_2,
empty,1,363,362,9,
sha_transform,363,559,196,8,
.LPIC0,559,697,138,8,
.L3,697,981,284,9,
.L2,981,1089,108,7,
.L5,1089,1653,564,10,
.L4,1653,2158,505,9,
.L7,2158,3035,877,10,
.L6,3035,3143,108,7,
.L9,3143,3959,816,10,
.L8,3959,4068,109,7,
.L11,4068,4981,913,10,
.L10,4981,5092,111,7,
.L13,5092,5909,817,10,
.L12,5909,6810,901,10,
.L14,6810,6877,67,7,
.L16,6877,6893,16,4,
.L15,6893,7102,209,8,
byte_reverse,7102,7292,190,8,
.LPIC1,7292,7500,208,8,
.L19,7500,8261,761,10,
.L18,8261,8441,180,8,
.L20,8441,8504,63,6,
.L22,8504,8520,16,4,
.L21,8520,8741,221,8,
sha_init,8741,9583,842,10,
sha_update,9583,10022,439,9,
.L25,10022,10291,269,9,
.L27,10291,10629,338,9,
.L26,10629,10982,353,9,
sha_final,10982,11875,893,10,
.L29,11875,12029,154,8,
.L30,12029,12477,448,9,
sha_stream,12477,12756,279,9,
.LPIC2,12756,12949,193,8,
.L33,12949,13106,157,8,
.L32,13106,13587,481,9,
.L34,13587,13673,86,7,
.L36,13673,13689,16,4,
.L35,13689,13825,136,8,
.LC0,13825,13997,172,8,
sha_print,13997,14407,410,9,
.LPIC3,14407,14509,102,7,
.L39,14509,14525,16,4,
.L38,14525,14531,59,6,
end,end,end,end,


LineNum,inLabel,command,JumpToLabel,jumpToAd,start_row_counter,
Label,StartPoint,EndPoint,Size,log_2,
empty,1,363,362,9,
sha_transform,363,559,196,8,
.LPIC0,559,697,138,8,
.L3,697,981,284,9,
.L2,981,1089,108,7,
.L5,1089,1653,564,10,
.L4,1653,2158,505,9,
.L7,2158,3035,877,10,
.L6,3035,3143,108,7,
.L9,3143,3959,816,10,
.L8,3959,4068,109,7,
.L11,4068,4981,913,10,
.L10,4981,5092,111,7,
.L13,5092,5909,817,10,
.L12,5909,6810,901,10,
.L14,6810,6877,67,7,
.L16,6877,6893,16,4,
.L15,6893,7102,209,8,
byte_reverse,7102,7292,190,8,
.LPIC1,7292,7500,208,8,
.L19,7500,8261,761,10,
.L18,8261,8441,180,8,
.L20,8441,8504,63,6,
.L22,8504,8520,16,4,
.L21,8520,8741,221,8,
sha_init,8741,9583,842,10,
sha_update,9583,10022,439,9,
.L25,10022,10291,269,9,
.L27,10291,10629,338,9,
.L26,10629,10982,353,9,
sha_final,10982,11875,893,10,
.L29,11875,12029,154,8,
.L30,12029,12477,448,9,
sha_stream,12477,12756,279,9,
.LPIC2,12756,12949,193,8,
.L33,12949,13106,157,8,
.L32,13106,13587,481,9,
.L34,13587,13673,86,7,
.L36,13673,13689,16,4,
.L35,13689,13825,136,8,
.LC0,13825,13997,172,8,
sha_print,13997,14407,410,9,
.LPIC3,14407,14509,102,7,
.L39,14509,14525,16,4,
.L38,14525,14531,59,6,
end,end,end,end,


LineNum,inLabel,command,JumpToLabel,jumpToAd,start_row_counter,
Label,StartPoint,EndPoint,Size,log_2,
empty,1,363,362,9,
sha_transform,363,559,196,8,
.LPIC0,559,697,138,8,
.L3,697,981,284,9,
.L2,981,1089,108,7,
.L5,1089,1653,564,10,
.L4,1653,2158,505,9,
.L7,2158,3035,877,10,
.L6,3035,3143,108,7,
.L9,3143,3959,816,10,
.L8,3959,4068,109,7,
.L11,4068,4981,913,10,
.L10,4981,5092,111,7,
.L13,5092,5909,817,10,
.L12,5909,6810,901,10,
.L14,6810,6877,67,7,
.L16,6877,6893,16,4,
.L15,6893,7102,209,8,
byte_reverse,7102,7292,190,8,
.LPIC1,7292,7500,208,8,
.L19,7500,8261,761,10,
.L18,8261,8441,180,8,
.L20,8441,8504,63,6,
.L22,8504,8520,16,4,
.L21,8520,8741,221,8,
sha_init,8741,9583,842,10,
sha_update,9583,10022,439,9,
.L25,10022,10291,269,9,
.L27,10291,10629,338,9,
.L26,10629,10982,353,9,
sha_final,10982,11875,893,10,
.L29,11875,12029,154,8,
.L30,12029,12477,448,9,
sha_stream,12477,12756,279,9,
.LPIC2,12756,12949,193,8,
.L33,12949,13106,157,8,
.L32,13106,13587,481,9,
.L34,13587,13673,86,7,
.L36,13673,13689,16,4,
.L35,13689,13825,136,8,
.LC0,13825,13997,172,8,
sha_print,13997,14407,410,9,
.LPIC3,14407,14509,102,7,
.L39,14509,14525,16,4,
.L38,14525,14531,59,6,
end,end,end,end,


LineNum,inLabel,command,JumpToLabel,jumpToAd,start_row_counter,
Label,StartPoint,EndPoint,Size,log_2,
empty,1,363,362,9,
sha_transform,363,559,196,8,
.LPIC0,559,697,138,8,
.L3,697,981,284,9,
.L2,981,1089,108,7,
.L5,1089,1653,564,10,
.L4,1653,2158,505,9,
.L7,2158,3035,877,10,
.L6,3035,3143,108,7,
.L9,3143,3959,816,10,
.L8,3959,4068,109,7,
.L11,4068,4981,913,10,
.L10,4981,5092,111,7,
.L13,5092,5909,817,10,
.L12,5909,6810,901,10,
.L14,6810,6877,67,7,
.L16,6877,6893,16,4,
.L15,6893,7102,209,8,
byte_reverse,7102,7292,190,8,
.LPIC1,7292,7500,208,8,
.L19,7500,8261,761,10,
.L18,8261,8441,180,8,
.L20,8441,8504,63,6,
.L22,8504,8520,16,4,
.L21,8520,8741,221,8,
sha_init,8741,9583,842,10,
sha_update,9583,10022,439,9,
.L25,10022,10291,269,9,
.L27,10291,10629,338,9,
.L26,10629,10982,353,9,
sha_final,10982,11875,893,10,
.L29,11875,12029,154,8,
.L30,12029,12477,448,9,
sha_stream,12477,12756,279,9,
.LPIC2,12756,12949,193,8,
.L33,12949,13106,157,8,
.L32,13106,13587,481,9,
.L34,13587,13673,86,7,
.L36,13673,13689,16,4,
.L35,13689,13825,136,8,
.LC0,13825,13997,172,8,
sha_print,13997,14407,410,9,
.LPIC3,14407,14509,102,7,
.L39,14509,14525,16,4,
.L38,14525,14531,59,6,
end,end,end,end,


LineNum,inLabel,command,JumpToLabel,jumpToAd,start_row_counter,
Label,StartPoint,EndPoint,Size,log_2,
empty,1,363,362,9,
sha_transform,363,559,196,8,
.LPIC0,559,697,138,8,
.L3,697,981,284,9,
.L2,981,1089,108,7,
.L5,1089,1653,564,10,
.L4,1653,2158,505,9,
.L7,2158,3035,877,10,
.L6,3035,3143,108,7,
.L9,3143,3959,816,10,
.L8,3959,4068,109,7,
.L11,4068,4981,913,10,
.L10,4981,5092,111,7,
.L13,5092,5909,817,10,
.L12,5909,6810,901,10,
.L14,6810,6877,67,7,
.L16,6877,6893,16,4,
.L15,6893,7102,209,8,
byte_reverse,7102,7292,190,8,
.LPIC1,7292,7500,208,8,
.L19,7500,8261,761,10,
.L18,8261,8441,180,8,
.L20,8441,8504,63,6,
.L22,8504,8520,16,4,
.L21,8520,8741,221,8,
sha_init,8741,9583,842,10,
sha_update,9583,10022,439,9,
.L25,10022,10291,269,9,
.L27,10291,10629,338,9,
.L26,10629,10982,353,9,
sha_final,10982,11875,893,10,
.L29,11875,12029,154,8,
.L30,12029,12477,448,9,
sha_stream,12477,12756,279,9,
.LPIC2,12756,12949,193,8,
.L33,12949,13106,157,8,
.L32,13106,13587,481,9,
.L34,13587,13673,86,7,
.L36,13673,13689,16,4,
.L35,13689,13825,136,8,
.LC0,13825,13997,172,8,
sha_print,13997,14407,410,9,
.LPIC3,14407,14509,102,7,
.L39,14509,14525,16,4,
.L38,14525,14531,59,6,
end,end,end,end,


LineNum,inLabel,command,JumpToLabel,jumpToAd,start_row_counter,
Label,StartPoint,EndPoint,Size,log_2,
empty,1,363,362,9,
sha_transform,363,559,196,8,
.LPIC0,559,697,138,8,
.L3,697,981,284,9,
.L2,981,1089,108,7,
.L5,1089,1653,564,10,
.L4,1653,2158,505,9,
.L7,2158,3035,877,10,
.L6,3035,3143,108,7,
.L9,3143,3959,816,10,
.L8,3959,4068,109,7,
.L11,4068,4981,913,10,
.L10,4981,5092,111,7,
.L13,5092,5909,817,10,
.L12,5909,6810,901,10,
.L14,6810,6877,67,7,
.L16,6877,6893,16,4,
.L15,6893,7102,209,8,
byte_reverse,7102,7292,190,8,
.LPIC1,7292,7500,208,8,
.L19,7500,8261,761,10,
.L18,8261,8441,180,8,
.L20,8441,8504,63,6,
.L22,8504,8520,16,4,
.L21,8520,8741,221,8,
sha_init,8741,9583,842,10,
sha_update,9583,10022,439,9,
.L25,10022,10291,269,9,
.L27,10291,10629,338,9,
.L26,10629,10982,353,9,
sha_final,10982,11875,893,10,
.L29,11875,12029,154,8,
.L30,12029,12477,448,9,
sha_stream,12477,12756,279,9,
.LPIC2,12756,12949,193,8,
.L33,12949,13106,157,8,
.L32,13106,13587,481,9,
.L34,13587,13673,86,7,
.L36,13673,13689,16,4,
.L35,13689,13825,136,8,
.LC0,13825,13997,172,8,
sha_print,13997,14407,410,9,
.LPIC3,14407,14509,102,7,
.L39,14509,14525,16,4,
.L38,14525,14531,59,6,
end,end,end,end,


LineNum,inLabel,command,JumpToLabel,jumpToAd,start_row_counter,
Label,StartPoint,EndPoint,Size,log_2,
empty,1,363,362,9,
sha_transform,363,559,196,8,
.LPIC0,559,697,138,8,
.L3,697,981,284,9,
.L2,981,1089,108,7,
.L5,1089,1653,564,10,
.L4,1653,2158,505,9,
.L7,2158,3035,877,10,
.L6,3035,3143,108,7,
.L9,3143,3959,816,10,
.L8,3959,4068,109,7,
.L11,4068,4981,913,10,
.L10,4981,5092,111,7,
.L13,5092,5909,817,10,
.L12,5909,6810,901,10,
.L14,6810,6877,67,7,
.L16,6877,6893,16,4,
.L15,6893,7102,209,8,
byte_reverse,7102,7292,190,8,
.LPIC1,7292,7500,208,8,
.L19,7500,8261,761,10,
.L18,8261,8441,180,8,
.L20,8441,8504,63,6,
.L22,8504,8520,16,4,
.L21,8520,8741,221,8,
sha_init,8741,9583,842,10,
sha_update,9583,10022,439,9,
.L25,10022,10291,269,9,
.L27,10291,10629,338,9,
.L26,10629,10982,353,9,
sha_final,10982,11875,893,10,
.L29,11875,12029,154,8,
.L30,12029,12477,448,9,
sha_stream,12477,12756,279,9,
.LPIC2,12756,12949,193,8,
.L33,12949,13106,157,8,
.L32,13106,13587,481,9,
.L34,13587,13673,86,7,
.L36,13673,13689,16,4,
.L35,13689,13825,136,8,
.LC0,13825,13997,172,8,
sha_print,13997,14407,410,9,
.LPIC3,14407,14509,102,7,
.L39,14509,14525,16,4,
.L38,14525,14531,59,6,
end,end,end,end,


LineNum,inLabel,command,JumpToLabel,jumpToAd,start_row_counter,
Label,StartPoint,EndPoint,Size,log_2,
empty,1,363,362,9,
sha_transform,363,559,196,8,
.LPIC0,559,697,138,8,
.L3,697,981,284,9,
.L2,981,1089,108,7,
.L5,1089,1653,564,10,
.L4,1653,2158,505,9,
.L7,2158,3035,877,10,
.L6,3035,3143,108,7,
.L9,3143,3959,816,10,
.L8,3959,4068,109,7,
.L11,4068,4981,913,10,
.L10,4981,5092,111,7,
.L13,5092,5909,817,10,
.L12,5909,6810,901,10,
.L14,6810,6877,67,7,
.L16,6877,6893,16,4,
.L15,6893,7102,209,8,
byte_reverse,7102,7292,190,8,
.LPIC1,7292,7500,208,8,
.L19,7500,8261,761,10,
.L18,8261,8441,180,8,
.L20,8441,8504,63,6,
.L22,8504,8520,16,4,
.L21,8520,8741,221,8,
sha_init,8741,9583,842,10,
sha_update,9583,10022,439,9,
.L25,10022,10291,269,9,
.L27,10291,10629,338,9,
.L26,10629,10982,353,9,
sha_final,10982,11875,893,10,
.L29,11875,12029,154,8,
.L30,12029,12477,448,9,
sha_stream,12477,12756,279,9,
.LPIC2,12756,12949,193,8,
.L33,12949,13106,157,8,
.L32,13106,13587,481,9,
.L34,13587,13673,86,7,
.L36,13673,13689,16,4,
.L35,13689,13825,136,8,
.LC0,13825,13997,172,8,
sha_print,13997,14407,410,9,
.LPIC3,14407,14509,102,7,
.L39,14509,14525,16,4,
.L38,14525,14531,59,6,
end,end,end,end,


LineNum,inLabel,command,JumpToLabel,jumpToAd,start_row_counter,
Label,StartPoint,EndPoint,Size,log_2,
empty,1,363,362,9,
sha_transform,363,559,196,8,
.LPIC0,559,697,138,8,
.L3,697,981,284,9,
.L2,981,1089,108,7,
.L5,1089,1653,564,10,
.L4,1653,2158,505,9,
.L7,2158,3035,877,10,
.L6,3035,3143,108,7,
.L9,3143,3959,816,10,
.L8,3959,4068,109,7,
.L11,4068,4981,913,10,
.L10,4981,5092,111,7,
.L13,5092,5909,817,10,
.L12,5909,6810,901,10,
.L14,6810,6877,67,7,
.L16,6877,6893,16,4,
.L15,6893,7102,209,8,
byte_reverse,7102,7292,190,8,
.LPIC1,7292,7500,208,8,
.L19,7500,8261,761,10,
.L18,8261,8441,180,8,
.L20,8441,8504,63,6,
.L22,8504,8520,16,4,
.L21,8520,8741,221,8,
sha_init,8741,9583,842,10,
sha_update,9583,10022,439,9,
.L25,10022,10291,269,9,
.L27,10291,10629,338,9,
.L26,10629,10982,353,9,
sha_final,10982,11875,893,10,
.L29,11875,12029,154,8,
.L30,12029,12477,448,9,
sha_stream,12477,12756,279,9,
.LPIC2,12756,12949,193,8,
.L33,12949,13106,157,8,
.L32,13106,13587,481,9,
.L34,13587,13673,86,7,
.L36,13673,13689,16,4,
.L35,13689,13825,136,8,
.LC0,13825,13997,172,8,
sha_print,13997,14407,410,9,
.LPIC3,14407,14509,102,7,
.L39,14509,14525,16,4,
.L38,14525,14531,59,6,
end,end,end,end,


LineNum,inLabel,command,JumpToLabel,jumpToAd,start_row_counter,
Label,StartPoint,EndPoint,Size,log_2,
empty,1,363,362,9,
sha_transform,363,559,196,8,
.LPIC0,559,697,138,8,
.L3,697,981,284,9,
.L2,981,1089,108,7,
.L5,1089,1653,564,10,
.L4,1653,2158,505,9,
.L7,2158,3035,877,10,
.L6,3035,3143,108,7,
.L9,3143,3959,816,10,
.L8,3959,4068,109,7,
.L11,4068,4981,913,10,
.L10,4981,5092,111,7,
.L13,5092,5909,817,10,
.L12,5909,6810,901,10,
.L14,6810,6877,67,7,
.L16,6877,6893,16,4,
.L15,6893,7102,209,8,
byte_reverse,7102,7292,190,8,
.LPIC1,7292,7500,208,8,
.L19,7500,8261,761,10,
.L18,8261,8441,180,8,
.L20,8441,8504,63,6,
.L22,8504,8520,16,4,
.L21,8520,8741,221,8,
sha_init,8741,9583,842,10,
sha_update,9583,10022,439,9,
.L25,10022,10291,269,9,
.L27,10291,10629,338,9,
.L26,10629,10982,353,9,
sha_final,10982,11875,893,10,
.L29,11875,12029,154,8,
.L30,12029,12477,448,9,
sha_stream,12477,12756,279,9,
.LPIC2,12756,12949,193,8,
.L33,12949,13106,157,8,
.L32,13106,13587,481,9,
.L34,13587,13673,86,7,
.L36,13673,13689,16,4,
.L35,13689,13825,136,8,
.LC0,13825,13997,172,8,
sha_print,13997,14407,410,9,
.LPIC3,14407,14509,102,7,
.L39,14509,14525,16,4,
.L38,14525,14531,59,6,
end,end,end,end,


LineNum,inLabel,command,JumpToLabel,jumpToAd,start_row_counter,
Label,StartPoint,EndPoint,Size,log_2,
empty,1,363,362,9,
sha_transform,363,559,196,8,
.LPIC0,559,697,138,8,
.L3,697,981,284,9,
.L2,981,1089,108,7,
.L5,1089,1653,564,10,
.L4,1653,2158,505,9,
.L7,2158,3035,877,10,
.L6,3035,3143,108,7,
.L9,3143,3959,816,10,
.L8,3959,4068,109,7,
.L11,4068,4981,913,10,
.L10,4981,5092,111,7,
.L13,5092,5909,817,10,
.L12,5909,6810,901,10,
.L14,6810,6877,67,7,
.L16,6877,6893,16,4,
.L15,6893,7102,209,8,
byte_reverse,7102,7292,190,8,
.LPIC1,7292,7500,208,8,
.L19,7500,8261,761,10,
.L18,8261,8441,180,8,
.L20,8441,8504,63,6,
.L22,8504,8520,16,4,
.L21,8520,8741,221,8,
sha_init,8741,9583,842,10,
sha_update,9583,10022,439,9,
.L25,10022,10291,269,9,
.L27,10291,10629,338,9,
.L26,10629,10982,353,9,
sha_final,10982,11875,893,10,
.L29,11875,12029,154,8,
.L30,12029,12477,448,9,
sha_stream,12477,12756,279,9,
.LPIC2,12756,12949,193,8,
.L33,12949,13106,157,8,
.L32,13106,13587,481,9,
.L34,13587,13673,86,7,
.L36,13673,13689,16,4,
.L35,13689,13825,136,8,
.LC0,13825,13997,172,8,
sha_print,13997,14407,410,9,
.LPIC3,14407,14509,102,7,
.L39,14509,14525,16,4,
.L38,14525,14531,59,6,
end,end,end,end,


LineNum,inLabel,command,JumpToLabel,jumpToAd,start_row_counter,
Label,StartPoint,EndPoint,Size,log_2,
empty,1,363,362,9,
sha_transform,363,559,196,8,
.LPIC0,559,697,138,8,
.L3,697,981,284,9,
.L2,981,1089,108,7,
.L5,1089,1653,564,10,
.L4,1653,2158,505,9,
.L7,2158,3035,877,10,
.L6,3035,3143,108,7,
.L9,3143,3959,816,10,
.L8,3959,4068,109,7,
.L11,4068,4981,913,10,
.L10,4981,5092,111,7,
.L13,5092,5909,817,10,
.L12,5909,6810,901,10,
.L14,6810,6877,67,7,
.L16,6877,6893,16,4,
.L15,6893,7102,209,8,
byte_reverse,7102,7292,190,8,
.LPIC1,7292,7500,208,8,
.L19,7500,8261,761,10,
.L18,8261,8441,180,8,
.L20,8441,8504,63,6,
.L22,8504,8520,16,4,
.L21,8520,8741,221,8,
sha_init,8741,9583,842,10,
sha_update,9583,10022,439,9,
.L25,10022,10291,269,9,
.L27,10291,10629,338,9,
.L26,10629,10982,353,9,
sha_final,10982,11875,893,10,
.L29,11875,12029,154,8,
.L30,12029,12477,448,9,
sha_stream,12477,12756,279,9,
.LPIC2,12756,12949,193,8,
.L33,12949,13106,157,8,
.L32,13106,13587,481,9,
.L34,13587,13673,86,7,
.L36,13673,13689,16,4,
.L35,13689,13825,136,8,
.LC0,13825,13997,172,8,
sha_print,13997,14407,410,9,
.LPIC3,14407,14509,102,7,
.L39,14509,14525,16,4,
.L38,14525,14531,59,6,
end,end,end,end,


LineNum,inLabel,command,JumpToLabel,jumpToAd,start_row_counter,
Label,StartPoint,EndPoint,Size,log_2,
empty,1,363,362,9,
sha_transform,363,559,196,8,
.LPIC0,559,697,138,8,
.L3,697,981,284,9,
.L2,981,1089,108,7,
.L5,1089,1653,564,10,
.L4,1653,2158,505,9,
.L7,2158,3035,877,10,
.L6,3035,3143,108,7,
.L9,3143,3959,816,10,
.L8,3959,4068,109,7,
.L11,4068,4981,913,10,
.L10,4981,5092,111,7,
.L13,5092,5909,817,10,
.L12,5909,6810,901,10,
.L14,6810,6877,67,7,
.L16,6877,6893,16,4,
.L15,6893,7102,209,8,
byte_reverse,7102,7292,190,8,
.LPIC1,7292,7500,208,8,
.L19,7500,8261,761,10,
.L18,8261,8441,180,8,
.L20,8441,8504,63,6,
.L22,8504,8520,16,4,
.L21,8520,8741,221,8,
sha_init,8741,9583,842,10,
sha_update,9583,10022,439,9,
.L25,10022,10291,269,9,
.L27,10291,10629,338,9,
.L26,10629,10982,353,9,
sha_final,10982,11875,893,10,
.L29,11875,12029,154,8,
.L30,12029,12477,448,9,
sha_stream,12477,12756,279,9,
.LPIC2,12756,12949,193,8,
.L33,12949,13106,157,8,
.L32,13106,13587,481,9,
.L34,13587,13673,86,7,
.L36,13673,13689,16,4,
.L35,13689,13825,136,8,
.LC0,13825,13997,172,8,
sha_print,13997,14407,410,9,
.LPIC3,14407,14509,102,7,
.L39,14509,14525,16,4,
.L38,14525,14531,59,6,
end,end,end,end,


LineNum,inLabel,command,JumpToLabel,jumpToAd,start_row_counter,
Label,StartPoint,EndPoint,Size,log_2,
empty,1,363,362,9,
sha_transform,363,559,196,8,
.LPIC0,559,697,138,8,
.L3,697,981,284,9,
.L2,981,1089,108,7,
.L5,1089,1653,564,10,
.L4,1653,2158,505,9,
.L7,2158,3035,877,10,
.L6,3035,3143,108,7,
.L9,3143,3959,816,10,
.L8,3959,4068,109,7,
.L11,4068,4981,913,10,
.L10,4981,5092,111,7,
.L13,5092,5909,817,10,
.L12,5909,6810,901,10,
.L14,6810,6877,67,7,
.L16,6877,6893,16,4,
.L15,6893,7102,209,8,
byte_reverse,7102,7292,190,8,
.LPIC1,7292,7500,208,8,
.L19,7500,8261,761,10,
.L18,8261,8441,180,8,
.L20,8441,8504,63,6,
.L22,8504,8520,16,4,
.L21,8520,8741,221,8,
sha_init,8741,9583,842,10,
sha_update,9583,10022,439,9,
.L25,10022,10291,269,9,
.L27,10291,10629,338,9,
.L26,10629,10982,353,9,
sha_final,10982,11875,893,10,
.L29,11875,12029,154,8,
.L30,12029,12477,448,9,
sha_stream,12477,12756,279,9,
.LPIC2,12756,12949,193,8,
.L33,12949,13106,157,8,
.L32,13106,13587,481,9,
.L34,13587,13673,86,7,
.L36,13673,13689,16,4,
.L35,13689,13825,136,8,
.LC0,13825,13997,172,8,
sha_print,13997,14407,410,9,
.LPIC3,14407,14509,102,7,
.L39,14509,14525,16,4,
.L38,14525,14531,59,6,
end,end,end,end,


LineNum,inLabel,command,JumpToLabel,jumpToAd,start_row_counter,
Label,StartPoint,EndPoint,Size,log_2,
empty,1,363,362,9,
sha_transform,363,559,196,8,
.LPIC0,559,697,138,8,
.L3,697,981,284,9,
.L2,981,1089,108,7,
.L5,1089,1653,564,10,
.L4,1653,2158,505,9,
.L7,2158,3035,877,10,
.L6,3035,3143,108,7,
.L9,3143,3959,816,10,
.L8,3959,4068,109,7,
.L11,4068,4981,913,10,
.L10,4981,5092,111,7,
.L13,5092,5909,817,10,
.L12,5909,6810,901,10,
.L14,6810,6877,67,7,
.L16,6877,6893,16,4,
.L15,6893,7102,209,8,
byte_reverse,7102,7292,190,8,
.LPIC1,7292,7500,208,8,
.L19,7500,8261,761,10,
.L18,8261,8441,180,8,
.L20,8441,8504,63,6,
.L22,8504,8520,16,4,
.L21,8520,8741,221,8,
sha_init,8741,9583,842,10,
sha_update,9583,10022,439,9,
.L25,10022,10291,269,9,
.L27,10291,10629,338,9,
.L26,10629,10982,353,9,
sha_final,10982,11875,893,10,
.L29,11875,12029,154,8,
.L30,12029,12477,448,9,
sha_stream,12477,12756,279,9,
.LPIC2,12756,12949,193,8,
.L33,12949,13106,157,8,
.L32,13106,13587,481,9,
.L34,13587,13673,86,7,
.L36,13673,13689,16,4,
.L35,13689,13825,136,8,
.LC0,13825,13997,172,8,
sha_print,13997,14407,410,9,
.LPIC3,14407,14509,102,7,
.L39,14509,14525,16,4,
.L38,14525,14531,59,6,
end,end,end,end,


LineNum,inLabel,command,JumpToLabel,jumpToAd,start_row_counter,
Label,StartPoint,EndPoint,Size,log_2,
empty,1,363,362,9,
sha_transform,363,559,196,8,
.LPIC0,559,697,138,8,
.L3,697,981,284,9,
.L2,981,1089,108,7,
.L5,1089,1653,564,10,
.L4,1653,2158,505,9,
.L7,2158,3035,877,10,
.L6,3035,3143,108,7,
.L9,3143,3959,816,10,
.L8,3959,4068,109,7,
.L11,4068,4981,913,10,
.L10,4981,5092,111,7,
.L13,5092,5909,817,10,
.L12,5909,6810,901,10,
.L14,6810,6877,67,7,
.L16,6877,6893,16,4,
.L15,6893,7102,209,8,
byte_reverse,7102,7292,190,8,
.LPIC1,7292,7500,208,8,
.L19,7500,8261,761,10,
.L18,8261,8441,180,8,
.L20,8441,8504,63,6,
.L22,8504,8520,16,4,
.L21,8520,8741,221,8,
sha_init,8741,9583,842,10,
sha_update,9583,10022,439,9,
.L25,10022,10291,269,9,
.L27,10291,10629,338,9,
.L26,10629,10982,353,9,
sha_final,10982,11875,893,10,
.L29,11875,12029,154,8,
.L30,12029,12477,448,9,
sha_stream,12477,12756,279,9,
.LPIC2,12756,12949,193,8,
.L33,12949,13106,157,8,
.L32,13106,13587,481,9,
.L34,13587,13673,86,7,
.L36,13673,13689,16,4,
.L35,13689,13825,136,8,
.LC0,13825,13997,172,8,
sha_print,13997,14407,410,9,
.LPIC3,14407,14509,102,7,
.L39,14509,14525,16,4,
.L38,14525,14531,59,6,
end,end,end,end,


LineNum,inLabel,command,JumpToLabel,jumpToAd,start_row_counter,
Label,StartPoint,EndPoint,Size,log_2,
empty,1,363,362,9,
sha_transform,363,559,196,8,
.LPIC0,559,697,138,8,
.L3,697,981,284,9,
.L2,981,1089,108,7,
.L5,1089,1653,564,10,
.L4,1653,2158,505,9,
.L7,2158,3035,877,10,
.L6,3035,3143,108,7,
.L9,3143,3959,816,10,
.L8,3959,4068,109,7,
.L11,4068,4981,913,10,
.L10,4981,5092,111,7,
.L13,5092,5909,817,10,
.L12,5909,6810,901,10,
.L14,6810,6877,67,7,
.L16,6877,6893,16,4,
.L15,6893,7102,209,8,
byte_reverse,7102,7292,190,8,
.LPIC1,7292,7500,208,8,
.L19,7500,8261,761,10,
.L18,8261,8441,180,8,
.L20,8441,8504,63,6,
.L22,8504,8520,16,4,
.L21,8520,8741,221,8,
sha_init,8741,9583,842,10,
sha_update,9583,10022,439,9,
.L25,10022,10291,269,9,
.L27,10291,10629,338,9,
.L26,10629,10982,353,9,
sha_final,10982,11875,893,10,
.L29,11875,12029,154,8,
.L30,12029,12477,448,9,
sha_stream,12477,12756,279,9,
.LPIC2,12756,12949,193,8,
.L33,12949,13106,157,8,
.L32,13106,13587,481,9,
.L34,13587,13673,86,7,
.L36,13673,13689,16,4,
.L35,13689,13825,136,8,
.LC0,13825,13997,172,8,
sha_print,13997,14407,410,9,
.LPIC3,14407,14509,102,7,
.L39,14509,14525,16,4,
.L38,14525,14531,59,6,
end,end,end,end,


LineNum,inLabel,command,JumpToLabel,jumpToAd,start_row_counter,
Label,StartPoint,EndPoint,Size,log_2,
empty,1,363,362,9,
sha_transform,363,559,196,8,
.LPIC0,559,697,138,8,
.L3,697,981,284,9,
.L2,981,1089,108,7,
.L5,1089,1653,564,10,
.L4,1653,2158,505,9,
.L7,2158,3035,877,10,
.L6,3035,3143,108,7,
.L9,3143,3959,816,10,
.L8,3959,4068,109,7,
.L11,4068,4981,913,10,
.L10,4981,5092,111,7,
.L13,5092,5909,817,10,
.L12,5909,6810,901,10,
.L14,6810,6877,67,7,
.L16,6877,6893,16,4,
.L15,6893,7102,209,8,
byte_reverse,7102,7292,190,8,
.LPIC1,7292,7500,208,8,
.L19,7500,8261,761,10,
.L18,8261,8441,180,8,
.L20,8441,8504,63,6,
.L22,8504,8520,16,4,
.L21,8520,8741,221,8,
sha_init,8741,9583,842,10,
sha_update,9583,10022,439,9,
.L25,10022,10291,269,9,
.L27,10291,10629,338,9,
.L26,10629,10982,353,9,
sha_final,10982,11875,893,10,
.L29,11875,12029,154,8,
.L30,12029,12477,448,9,
sha_stream,12477,12756,279,9,
.LPIC2,12756,12949,193,8,
.L33,12949,13106,157,8,
.L32,13106,13587,481,9,
.L34,13587,13673,86,7,
.L36,13673,13689,16,4,
.L35,13689,13825,136,8,
.LC0,13825,13997,172,8,
sha_print,13997,14407,410,9,
.LPIC3,14407,14509,102,7,
.L39,14509,14525,16,4,
.L38,14525,14531,59,6,
end,end,end,end,


LineNum,inLabel,command,JumpToLabel,jumpToAd,start_row_counter,
Label,StartPoint,EndPoint,Size,log_2,
empty,1,363,362,9,
sha_transform,363,559,196,8,
.LPIC0,559,697,138,8,
.L3,697,981,284,9,
.L2,981,1089,108,7,
.L5,1089,1653,564,10,
.L4,1653,2158,505,9,
.L7,2158,3035,877,10,
.L6,3035,3143,108,7,
.L9,3143,3959,816,10,
.L8,3959,4068,109,7,
.L11,4068,4981,913,10,
.L10,4981,5092,111,7,
.L13,5092,5909,817,10,
.L12,5909,6810,901,10,
.L14,6810,6877,67,7,
.L16,6877,6893,16,4,
.L15,6893,7102,209,8,
byte_reverse,7102,7292,190,8,
.LPIC1,7292,7500,208,8,
.L19,7500,8261,761,10,
.L18,8261,8441,180,8,
.L20,8441,8504,63,6,
.L22,8504,8520,16,4,
.L21,8520,8741,221,8,
sha_init,8741,9583,842,10,
sha_update,9583,10022,439,9,
.L25,10022,10291,269,9,
.L27,10291,10629,338,9,
.L26,10629,10982,353,9,
sha_final,10982,11875,893,10,
.L29,11875,12029,154,8,
.L30,12029,12477,448,9,
sha_stream,12477,12756,279,9,
.LPIC2,12756,12949,193,8,
.L33,12949,13106,157,8,
.L32,13106,13587,481,9,
.L34,13587,13673,86,7,
.L36,13673,13689,16,4,
.L35,13689,13825,136,8,
.LC0,13825,13997,172,8,
sha_print,13997,14407,410,9,
.LPIC3,14407,14509,102,7,
.L39,14509,14525,16,4,
.L38,14525,14531,59,6,
end,end,end,end,


LineNum,inLabel,command,JumpToLabel,jumpToAd,start_row_counter,
Label,StartPoint,EndPoint,Size,log_2,
empty,1,363,362,9,
sha_transform,363,559,196,8,
.LPIC0,559,697,138,8,
.L3,697,981,284,9,
.L2,981,1089,108,7,
.L5,1089,1653,564,10,
.L4,1653,2158,505,9,
.L7,2158,3035,877,10,
.L6,3035,3143,108,7,
.L9,3143,3959,816,10,
.L8,3959,4068,109,7,
.L11,4068,4981,913,10,
.L10,4981,5092,111,7,
.L13,5092,5909,817,10,
.L12,5909,6810,901,10,
.L14,6810,6877,67,7,
.L16,6877,6893,16,4,
.L15,6893,7102,209,8,
byte_reverse,7102,7292,190,8,
.LPIC1,7292,7500,208,8,
.L19,7500,8261,761,10,
.L18,8261,8441,180,8,
.L20,8441,8504,63,6,
.L22,8504,8520,16,4,
.L21,8520,8741,221,8,
sha_init,8741,9583,842,10,
sha_update,9583,10022,439,9,
.L25,10022,10291,269,9,
.L27,10291,10629,338,9,
.L26,10629,10982,353,9,
sha_final,10982,11875,893,10,
.L29,11875,12029,154,8,
.L30,12029,12477,448,9,
sha_stream,12477,12756,279,9,
.LPIC2,12756,12949,193,8,
.L33,12949,13106,157,8,
.L32,13106,13587,481,9,
.L34,13587,13673,86,7,
.L36,13673,13689,16,4,
.L35,13689,13825,136,8,
.LC0,13825,13997,172,8,
sha_print,13997,14407,410,9,
.LPIC3,14407,14509,102,7,
.L39,14509,14525,16,4,
.L38,14525,14531,59,6,
end,end,end,end,


LineNum,inLabel,command,JumpToLabel,jumpToAd,start_row_counter,
Label,StartPoint,EndPoint,Size,log_2,
empty,1,363,362,9,
sha_transform,363,559,196,8,
.LPIC0,559,697,138,8,
.L3,697,981,284,9,
.L2,981,1089,108,7,
.L5,1089,1653,564,10,
.L4,1653,2158,505,9,
.L7,2158,3035,877,10,
.L6,3035,3143,108,7,
.L9,3143,3959,816,10,
.L8,3959,4068,109,7,
.L11,4068,4981,913,10,
.L10,4981,5092,111,7,
.L13,5092,5909,817,10,
.L12,5909,6810,901,10,
.L14,6810,6877,67,7,
.L16,6877,6893,16,4,
.L15,6893,7102,209,8,
byte_reverse,7102,7292,190,8,
.LPIC1,7292,7500,208,8,
.L19,7500,8261,761,10,
.L18,8261,8441,180,8,
.L20,8441,8504,63,6,
.L22,8504,8520,16,4,
.L21,8520,8741,221,8,
sha_init,8741,9583,842,10,
sha_update,9583,10022,439,9,
.L25,10022,10291,269,9,
.L27,10291,10629,338,9,
.L26,10629,10982,353,9,
sha_final,10982,11875,893,10,
.L29,11875,12029,154,8,
.L30,12029,12477,448,9,
sha_stream,12477,12756,279,9,
.LPIC2,12756,12949,193,8,
.L33,12949,13106,157,8,
.L32,13106,13587,481,9,
.L34,13587,13673,86,7,
.L36,13673,13689,16,4,
.L35,13689,13825,136,8,
.LC0,13825,13997,172,8,
sha_print,13997,14407,410,9,
.LPIC3,14407,14509,102,7,
.L39,14509,14525,16,4,
.L38,14525,14531,59,6,
end,end,end,end,


LineNum,inLabel,command,JumpToLabel,jumpToAd,start_row_counter,
Label,StartPoint,EndPoint,Size,log_2,
empty,1,363,362,9,
sha_transform,363,559,196,8,
.LPIC0,559,697,138,8,
.L3,697,981,284,9,
.L2,981,1089,108,7,
.L5,1089,1653,564,10,
.L4,1653,2158,505,9,
.L7,2158,3035,877,10,
.L6,3035,3143,108,7,
.L9,3143,3959,816,10,
.L8,3959,4068,109,7,
.L11,4068,4981,913,10,
.L10,4981,5092,111,7,
.L13,5092,5909,817,10,
.L12,5909,6810,901,10,
.L14,6810,6877,67,7,
.L16,6877,6893,16,4,
.L15,6893,7102,209,8,
byte_reverse,7102,7292,190,8,
.LPIC1,7292,7500,208,8,
.L19,7500,8261,761,10,
.L18,8261,8441,180,8,
.L20,8441,8504,63,6,
.L22,8504,8520,16,4,
.L21,8520,8741,221,8,
sha_init,8741,9583,842,10,
sha_update,9583,10022,439,9,
.L25,10022,10291,269,9,
.L27,10291,10629,338,9,
.L26,10629,10982,353,9,
sha_final,10982,11875,893,10,
.L29,11875,12029,154,8,
.L30,12029,12477,448,9,
sha_stream,12477,12756,279,9,
.LPIC2,12756,12949,193,8,
.L33,12949,13106,157,8,
.L32,13106,13587,481,9,
.L34,13587,13673,86,7,
.L36,13673,13689,16,4,
.L35,13689,13825,136,8,
.LC0,13825,13997,172,8,
sha_print,13997,14407,410,9,
.LPIC3,14407,14509,102,7,
.L39,14509,14525,16,4,
.L38,14525,14531,59,6,
end,end,end,end,


LineNum,inLabel,command,JumpToLabel,jumpToAd,start_row_counter,
Label,StartPoint,EndPoint,Size,log_2,
empty,1,363,362,9,
sha_transform,363,559,196,8,
.LPIC0,559,697,138,8,
.L3,697,981,284,9,
.L2,981,1089,108,7,
.L5,1089,1653,564,10,
.L4,1653,2158,505,9,
.L7,2158,3035,877,10,
.L6,3035,3143,108,7,
.L9,3143,3959,816,10,
.L8,3959,4068,109,7,
.L11,4068,4981,913,10,
.L10,4981,5092,111,7,
.L13,5092,5909,817,10,
.L12,5909,6810,901,10,
.L14,6810,6877,67,7,
.L16,6877,6893,16,4,
.L15,6893,7102,209,8,
byte_reverse,7102,7292,190,8,
.LPIC1,7292,7500,208,8,
.L19,7500,8261,761,10,
.L18,8261,8441,180,8,
.L20,8441,8504,63,6,
.L22,8504,8520,16,4,
.L21,8520,8741,221,8,
sha_init,8741,9583,842,10,
sha_update,9583,10022,439,9,
.L25,10022,10291,269,9,
.L27,10291,10629,338,9,
.L26,10629,10982,353,9,
sha_final,10982,11875,893,10,
.L29,11875,12029,154,8,
.L30,12029,12477,448,9,
sha_stream,12477,12756,279,9,
.LPIC2,12756,12949,193,8,
.L33,12949,13106,157,8,
.L32,13106,13587,481,9,
.L34,13587,13673,86,7,
.L36,13673,13689,16,4,
.L35,13689,13825,136,8,
.LC0,13825,13997,172,8,
sha_print,13997,14407,410,9,
.LPIC3,14407,14509,102,7,
.L39,14509,14525,16,4,
.L38,14525,14531,59,6,
end,end,end,end,


LineNum,inLabel,command,JumpToLabel,jumpToAd,start_row_counter,
Label,StartPoint,EndPoint,Size,log_2,
empty,1,363,362,9,
sha_transform,363,559,196,8,
.LPIC0,559,697,138,8,
.L3,697,981,284,9,
.L2,981,1089,108,7,
.L5,1089,1653,564,10,
.L4,1653,2158,505,9,
.L7,2158,3035,877,10,
.L6,3035,3143,108,7,
.L9,3143,3959,816,10,
.L8,3959,4068,109,7,
.L11,4068,4981,913,10,
.L10,4981,5092,111,7,
.L13,5092,5909,817,10,
.L12,5909,6810,901,10,
.L14,6810,6877,67,7,
.L16,6877,6893,16,4,
.L15,6893,7102,209,8,
byte_reverse,7102,7292,190,8,
.LPIC1,7292,7500,208,8,
.L19,7500,8261,761,10,
.L18,8261,8441,180,8,
.L20,8441,8504,63,6,
.L22,8504,8520,16,4,
.L21,8520,8741,221,8,
sha_init,8741,9583,842,10,
sha_update,9583,10022,439,9,
.L25,10022,10291,269,9,
.L27,10291,10629,338,9,
.L26,10629,10982,353,9,
sha_final,10982,11875,893,10,
.L29,11875,12029,154,8,
.L30,12029,12477,448,9,
sha_stream,12477,12756,279,9,
.LPIC2,12756,12949,193,8,
.L33,12949,13106,157,8,
.L32,13106,13587,481,9,
.L34,13587,13673,86,7,
.L36,13673,13689,16,4,
.L35,13689,13825,136,8,
.LC0,13825,13997,172,8,
sha_print,13997,14407,410,9,
.LPIC3,14407,14509,102,7,
.L39,14509,14525,16,4,
.L38,14525,14531,59,6,
end,end,end,end,


LineNum,inLabel,command,JumpToLabel,jumpToAd,start_row_counter,
Label,StartPoint,EndPoint,Size,log_2,
empty,1,363,362,9,
sha_transform,363,559,196,8,
.LPIC0,559,697,138,8,
.L3,697,981,284,9,
.L2,981,1089,108,7,
.L5,1089,1653,564,10,
.L4,1653,2158,505,9,
.L7,2158,3035,877,10,
.L6,3035,3143,108,7,
.L9,3143,3959,816,10,
.L8,3959,4068,109,7,
.L11,4068,4981,913,10,
.L10,4981,5092,111,7,
.L13,5092,5909,817,10,
.L12,5909,6810,901,10,
.L14,6810,6877,67,7,
.L16,6877,6893,16,4,
.L15,6893,7102,209,8,
byte_reverse,7102,7292,190,8,
.LPIC1,7292,7500,208,8,
.L19,7500,8261,761,10,
.L18,8261,8441,180,8,
.L20,8441,8504,63,6,
.L22,8504,8520,16,4,
.L21,8520,8741,221,8,
sha_init,8741,9583,842,10,
sha_update,9583,10022,439,9,
.L25,10022,10291,269,9,
.L27,10291,10629,338,9,
.L26,10629,10982,353,9,
sha_final,10982,11875,893,10,
.L29,11875,12029,154,8,
.L30,12029,12477,448,9,
sha_stream,12477,12756,279,9,
.LPIC2,12756,12949,193,8,
.L33,12949,13106,157,8,
.L32,13106,13587,481,9,
.L34,13587,13673,86,7,
.L36,13673,13689,16,4,
.L35,13689,13825,136,8,
.LC0,13825,13997,172,8,
sha_print,13997,14407,410,9,
.LPIC3,14407,14509,102,7,
.L39,14509,14525,16,4,
.L38,14525,14531,59,6,
end,end,end,end,


LineNum,inLabel,command,JumpToLabel,jumpToAd,start_row_counter,
Label,StartPoint,EndPoint,Size,log_2,
empty,1,363,362,9,
sha_transform,363,559,196,8,
.LPIC0,559,697,138,8,
.L3,697,981,284,9,
.L2,981,1089,108,7,
.L5,1089,1653,564,10,
.L4,1653,2158,505,9,
.L7,2158,3035,877,10,
.L6,3035,3143,108,7,
.L9,3143,3959,816,10,
.L8,3959,4068,109,7,
.L11,4068,4981,913,10,
.L10,4981,5092,111,7,
.L13,5092,5909,817,10,
.L12,5909,6810,901,10,
.L14,6810,6877,67,7,
.L16,6877,6893,16,4,
.L15,6893,7102,209,8,
byte_reverse,7102,7292,190,8,
.LPIC1,7292,7500,208,8,
.L19,7500,8261,761,10,
.L18,8261,8441,180,8,
.L20,8441,8504,63,6,
.L22,8504,8520,16,4,
.L21,8520,8741,221,8,
sha_init,8741,9583,842,10,
sha_update,9583,10022,439,9,
.L25,10022,10291,269,9,
.L27,10291,10629,338,9,
.L26,10629,10982,353,9,
sha_final,10982,11875,893,10,
.L29,11875,12029,154,8,
.L30,12029,12477,448,9,
sha_stream,12477,12756,279,9,
.LPIC2,12756,12949,193,8,
.L33,12949,13106,157,8,
.L32,13106,13587,481,9,
.L34,13587,13673,86,7,
.L36,13673,13689,16,4,
.L35,13689,13825,136,8,
.LC0,13825,13997,172,8,
sha_print,13997,14407,410,9,
.LPIC3,14407,14509,102,7,
.L39,14509,14525,16,4,
.L38,14525,14531,59,6,
end,end,end,end,


LineNum,inLabel,command,JumpToLabel,jumpToAd,start_row_counter,
Label,StartPoint,EndPoint,Size,log_2,
empty,1,363,362,9,
sha_transform,363,559,196,8,
.LPIC0,559,697,138,8,
.L3,697,981,284,9,
.L2,981,1089,108,7,
.L5,1089,1653,564,10,
.L4,1653,2158,505,9,
.L7,2158,3035,877,10,
.L6,3035,3143,108,7,
.L9,3143,3959,816,10,
.L8,3959,4068,109,7,
.L11,4068,4981,913,10,
.L10,4981,5092,111,7,
.L13,5092,5909,817,10,
.L12,5909,6810,901,10,
.L14,6810,6877,67,7,
.L16,6877,6893,16,4,
.L15,6893,7102,209,8,
byte_reverse,7102,7292,190,8,
.LPIC1,7292,7500,208,8,
.L19,7500,8261,761,10,
.L18,8261,8441,180,8,
.L20,8441,8504,63,6,
.L22,8504,8520,16,4,
.L21,8520,8741,221,8,
sha_init,8741,9583,842,10,
sha_update,9583,10022,439,9,
.L25,10022,10291,269,9,
.L27,10291,10629,338,9,
.L26,10629,10982,353,9,
sha_final,10982,11875,893,10,
.L29,11875,12029,154,8,
.L30,12029,12477,448,9,
sha_stream,12477,12756,279,9,
.LPIC2,12756,12949,193,8,
.L33,12949,13106,157,8,
.L32,13106,13587,481,9,
.L34,13587,13673,86,7,
.L36,13673,13689,16,4,
.L35,13689,13825,136,8,
.LC0,13825,13997,172,8,
sha_print,13997,14407,410,9,
.LPIC3,14407,14509,102,7,
.L39,14509,14525,16,4,
.L38,14525,14531,59,6,
end,end,end,end,


LineNum,inLabel,command,JumpToLabel,jumpToAd,start_row_counter,
Label,StartPoint,EndPoint,Size,log_2,
empty,1,363,362,9,
sha_transform,363,559,196,8,
.LPIC0,559,697,138,8,
.L3,697,981,284,9,
.L2,981,1089,108,7,
.L5,1089,1653,564,10,
.L4,1653,2158,505,9,
.L7,2158,3035,877,10,
.L6,3035,3143,108,7,
.L9,3143,3959,816,10,
.L8,3959,4068,109,7,
.L11,4068,4981,913,10,
.L10,4981,5092,111,7,
.L13,5092,5909,817,10,
.L12,5909,6810,901,10,
.L14,6810,6877,67,7,
.L16,6877,6893,16,4,
.L15,6893,7102,209,8,
byte_reverse,7102,7292,190,8,
.LPIC1,7292,7500,208,8,
.L19,7500,8261,761,10,
.L18,8261,8441,180,8,
.L20,8441,8504,63,6,
.L22,8504,8520,16,4,
.L21,8520,8741,221,8,
sha_init,8741,9583,842,10,
sha_update,9583,10022,439,9,
.L25,10022,10291,269,9,
.L27,10291,10629,338,9,
.L26,10629,10982,353,9,
sha_final,10982,11875,893,10,
.L29,11875,12029,154,8,
.L30,12029,12477,448,9,
sha_stream,12477,12756,279,9,
.LPIC2,12756,12949,193,8,
.L33,12949,13106,157,8,
.L32,13106,13587,481,9,
.L34,13587,13673,86,7,
.L36,13673,13689,16,4,
.L35,13689,13825,136,8,
.LC0,13825,13997,172,8,
sha_print,13997,14407,410,9,
.LPIC3,14407,14509,102,7,
.L39,14509,14525,16,4,
.L38,14525,14531,59,6,
end,end,end,end,


LineNum,inLabel,command,JumpToLabel,jumpToAd,start_row_counter,
Label,StartPoint,EndPoint,Size,log_2,
empty,1,363,362,9,
sha_transform,363,559,196,8,
.LPIC0,559,697,138,8,
.L3,697,981,284,9,
.L2,981,1089,108,7,
.L5,1089,1653,564,10,
.L4,1653,2158,505,9,
.L7,2158,3035,877,10,
.L6,3035,3143,108,7,
.L9,3143,3959,816,10,
.L8,3959,4068,109,7,
.L11,4068,4981,913,10,
.L10,4981,5092,111,7,
.L13,5092,5909,817,10,
.L12,5909,6810,901,10,
.L14,6810,6877,67,7,
.L16,6877,6893,16,4,
.L15,6893,7102,209,8,
byte_reverse,7102,7292,190,8,
.LPIC1,7292,7500,208,8,
.L19,7500,8261,761,10,
.L18,8261,8441,180,8,
.L20,8441,8504,63,6,
.L22,8504,8520,16,4,
.L21,8520,8741,221,8,
sha_init,8741,9583,842,10,
sha_update,9583,10022,439,9,
.L25,10022,10291,269,9,
.L27,10291,10629,338,9,
.L26,10629,10982,353,9,
sha_final,10982,11875,893,10,
.L29,11875,12029,154,8,
.L30,12029,12477,448,9,
sha_stream,12477,12756,279,9,
.LPIC2,12756,12949,193,8,
.L33,12949,13106,157,8,
.L32,13106,13587,481,9,
.L34,13587,13673,86,7,
.L36,13673,13689,16,4,
.L35,13689,13825,136,8,
.LC0,13825,13997,172,8,
sha_print,13997,14407,410,9,
.LPIC3,14407,14509,102,7,
.L39,14509,14525,16,4,
.L38,14525,14531,59,6,
end,end,end,end,


LineNum,inLabel,command,JumpToLabel,jumpToAd,start_row_counter,
Label,StartPoint,EndPoint,Size,log_2,
empty,1,363,362,9,
sha_transform,363,559,196,8,
.LPIC0,559,697,138,8,
.L3,697,981,284,9,
.L2,981,1089,108,7,
.L5,1089,1653,564,10,
.L4,1653,2158,505,9,
.L7,2158,3035,877,10,
.L6,3035,3143,108,7,
.L9,3143,3959,816,10,
.L8,3959,4068,109,7,
.L11,4068,4981,913,10,
.L10,4981,5092,111,7,
.L13,5092,5909,817,10,
.L12,5909,6810,901,10,
.L14,6810,6877,67,7,
.L16,6877,6893,16,4,
.L15,6893,7102,209,8,
byte_reverse,7102,7292,190,8,
.LPIC1,7292,7500,208,8,
.L19,7500,8261,761,10,
.L18,8261,8441,180,8,
.L20,8441,8504,63,6,
.L22,8504,8520,16,4,
.L21,8520,8741,221,8,
sha_init,8741,9583,842,10,
sha_update,9583,10022,439,9,
.L25,10022,10291,269,9,
.L27,10291,10629,338,9,
.L26,10629,10982,353,9,
sha_final,10982,11875,893,10,
.L29,11875,12029,154,8,
.L30,12029,12477,448,9,
sha_stream,12477,12756,279,9,
.LPIC2,12756,12949,193,8,
.L33,12949,13106,157,8,
.L32,13106,13587,481,9,
.L34,13587,13673,86,7,
.L36,13673,13689,16,4,
.L35,13689,13825,136,8,
.LC0,13825,13997,172,8,
sha_print,13997,14407,410,9,
.LPIC3,14407,14509,102,7,
.L39,14509,14525,16,4,
.L38,14525,14531,59,6,
end,end,end,end,


LineNum,inLabel,command,JumpToLabel,jumpToAd,start_row_counter,
Label,StartPoint,EndPoint,Size,log_2,
empty,1,363,362,9,
sha_transform,363,559,196,8,
.LPIC0,559,697,138,8,
.L3,697,981,284,9,
.L2,981,1089,108,7,
.L5,1089,1653,564,10,
.L4,1653,2158,505,9,
.L7,2158,3035,877,10,
.L6,3035,3143,108,7,
.L9,3143,3959,816,10,
.L8,3959,4068,109,7,
.L11,4068,4981,913,10,
.L10,4981,5092,111,7,
.L13,5092,5909,817,10,
.L12,5909,6810,901,10,
.L14,6810,6877,67,7,
.L16,6877,6893,16,4,
.L15,6893,7102,209,8,
byte_reverse,7102,7292,190,8,
.LPIC1,7292,7500,208,8,
.L19,7500,8261,761,10,
.L18,8261,8441,180,8,
.L20,8441,8504,63,6,
.L22,8504,8520,16,4,
.L21,8520,8741,221,8,
sha_init,8741,9583,842,10,
sha_update,9583,10022,439,9,
.L25,10022,10291,269,9,
.L27,10291,10629,338,9,
.L26,10629,10982,353,9,
sha_final,10982,11875,893,10,
.L29,11875,12029,154,8,
.L30,12029,12477,448,9,
sha_stream,12477,12756,279,9,
.LPIC2,12756,12949,193,8,
.L33,12949,13106,157,8,
.L32,13106,13587,481,9,
.L34,13587,13673,86,7,
.L36,13673,13689,16,4,
.L35,13689,13825,136,8,
.LC0,13825,13997,172,8,
sha_print,13997,14407,410,9,
.LPIC3,14407,14509,102,7,
.L39,14509,14525,16,4,
.L38,14525,14531,59,6,
end,end,end,end,


LineNum,inLabel,command,JumpToLabel,jumpToAd,start_row_counter,
Label,StartPoint,EndPoint,Size,log_2,
empty,1,363,362,9,
sha_transform,363,559,196,8,
.LPIC0,559,697,138,8,
.L3,697,981,284,9,
.L2,981,1089,108,7,
.L5,1089,1653,564,10,
.L4,1653,2158,505,9,
.L7,2158,3035,877,10,
.L6,3035,3143,108,7,
.L9,3143,3959,816,10,
.L8,3959,4068,109,7,
.L11,4068,4981,913,10,
.L10,4981,5092,111,7,
.L13,5092,5909,817,10,
.L12,5909,6810,901,10,
.L14,6810,6877,67,7,
.L16,6877,6893,16,4,
.L15,6893,7102,209,8,
byte_reverse,7102,7292,190,8,
.LPIC1,7292,7500,208,8,
.L19,7500,8261,761,10,
.L18,8261,8441,180,8,
.L20,8441,8504,63,6,
.L22,8504,8520,16,4,
.L21,8520,8741,221,8,
sha_init,8741,9583,842,10,
sha_update,9583,10022,439,9,
.L25,10022,10291,269,9,
.L27,10291,10629,338,9,
.L26,10629,10982,353,9,
sha_final,10982,11875,893,10,
.L29,11875,12029,154,8,
.L30,12029,12477,448,9,
sha_stream,12477,12756,279,9,
.LPIC2,12756,12949,193,8,
.L33,12949,13106,157,8,
.L32,13106,13587,481,9,
.L34,13587,13673,86,7,
.L36,13673,13689,16,4,
.L35,13689,13825,136,8,
.LC0,13825,13997,172,8,
sha_print,13997,14407,410,9,
.LPIC3,14407,14509,102,7,
.L39,14509,14525,16,4,
.L38,14525,14531,59,6,
end,end,end,end,


LineNum,inLabel,command,JumpToLabel,jumpToAd,start_row_counter,
Label,StartPoint,EndPoint,Size,log_2,
empty,1,363,362,9,
sha_transform,363,559,196,8,
.LPIC0,559,697,138,8,
.L3,697,981,284,9,
.L2,981,1089,108,7,
.L5,1089,1653,564,10,
.L4,1653,2158,505,9,
.L7,2158,3035,877,10,
.L6,3035,3143,108,7,
.L9,3143,3959,816,10,
.L8,3959,4068,109,7,
.L11,4068,4981,913,10,
.L10,4981,5092,111,7,
.L13,5092,5909,817,10,
.L12,5909,6810,901,10,
.L14,6810,6877,67,7,
.L16,6877,6893,16,4,
.L15,6893,7102,209,8,
byte_reverse,7102,7292,190,8,
.LPIC1,7292,7500,208,8,
.L19,7500,8261,761,10,
.L18,8261,8441,180,8,
.L20,8441,8504,63,6,
.L22,8504,8520,16,4,
.L21,8520,8741,221,8,
sha_init,8741,9583,842,10,
sha_update,9583,10022,439,9,
.L25,10022,10291,269,9,
.L27,10291,10629,338,9,
.L26,10629,10982,353,9,
sha_final,10982,11875,893,10,
.L29,11875,12029,154,8,
.L30,12029,12477,448,9,
sha_stream,12477,12756,279,9,
.LPIC2,12756,12949,193,8,
.L33,12949,13106,157,8,
.L32,13106,13587,481,9,
.L34,13587,13673,86,7,
.L36,13673,13689,16,4,
.L35,13689,13825,136,8,
.LC0,13825,13997,172,8,
sha_print,13997,14407,410,9,
.LPIC3,14407,14509,102,7,
.L39,14509,14525,16,4,
.L38,14525,14531,59,6,
end,end,end,end,


LineNum,inLabel,command,JumpToLabel,jumpToAd,start_row_counter,
Label,StartPoint,EndPoint,Size,log_2,
empty,1,363,362,9,
sha_transform,363,559,196,8,
.LPIC0,559,697,138,8,
.L3,697,981,284,9,
.L2,981,1089,108,7,
.L5,1089,1653,564,10,
.L4,1653,2158,505,9,
.L7,2158,3035,877,10,
.L6,3035,3143,108,7,
.L9,3143,3959,816,10,
.L8,3959,4068,109,7,
.L11,4068,4981,913,10,
.L10,4981,5092,111,7,
.L13,5092,5909,817,10,
.L12,5909,6810,901,10,
.L14,6810,6877,67,7,
.L16,6877,6893,16,4,
.L15,6893,7102,209,8,
byte_reverse,7102,7292,190,8,
.LPIC1,7292,7500,208,8,
.L19,7500,8261,761,10,
.L18,8261,8441,180,8,
.L20,8441,8504,63,6,
.L22,8504,8520,16,4,
.L21,8520,8741,221,8,
sha_init,8741,9583,842,10,
sha_update,9583,10022,439,9,
.L25,10022,10291,269,9,
.L27,10291,10629,338,9,
.L26,10629,10982,353,9,
sha_final,10982,11875,893,10,
.L29,11875,12029,154,8,
.L30,12029,12477,448,9,
sha_stream,12477,12756,279,9,
.LPIC2,12756,12949,193,8,
.L33,12949,13106,157,8,
.L32,13106,13587,481,9,
.L34,13587,13673,86,7,
.L36,13673,13689,16,4,
.L35,13689,13825,136,8,
.LC0,13825,13997,172,8,
sha_print,13997,14407,410,9,
.LPIC3,14407,14509,102,7,
.L39,14509,14525,16,4,
.L38,14525,14531,59,6,
end,end,end,end,


LineNum,inLabel,command,JumpToLabel,jumpToAd,start_row_counter,
Label,StartPoint,EndPoint,Size,log_2,
empty,1,363,362,9,
sha_transform,363,559,196,8,
.LPIC0,559,697,138,8,
.L3,697,981,284,9,
.L2,981,1089,108,7,
.L5,1089,1653,564,10,
.L4,1653,2158,505,9,
.L7,2158,3035,877,10,
.L6,3035,3143,108,7,
.L9,3143,3959,816,10,
.L8,3959,4068,109,7,
.L11,4068,4981,913,10,
.L10,4981,5092,111,7,
.L13,5092,5909,817,10,
.L12,5909,6810,901,10,
.L14,6810,6877,67,7,
.L16,6877,6893,16,4,
.L15,6893,7102,209,8,
byte_reverse,7102,7292,190,8,
.LPIC1,7292,7500,208,8,
.L19,7500,8261,761,10,
.L18,8261,8441,180,8,
.L20,8441,8504,63,6,
.L22,8504,8520,16,4,
.L21,8520,8741,221,8,
sha_init,8741,9583,842,10,
sha_update,9583,10022,439,9,
.L25,10022,10291,269,9,
.L27,10291,10629,338,9,
.L26,10629,10982,353,9,
sha_final,10982,11875,893,10,
.L29,11875,12029,154,8,
.L30,12029,12477,448,9,
sha_stream,12477,12756,279,9,
.LPIC2,12756,12949,193,8,
.L33,12949,13106,157,8,
.L32,13106,13587,481,9,
.L34,13587,13673,86,7,
.L36,13673,13689,16,4,
.L35,13689,13825,136,8,
.LC0,13825,13997,172,8,
sha_print,13997,14407,410,9,
.LPIC3,14407,14509,102,7,
.L39,14509,14525,16,4,
.L38,14525,14531,59,6,
end,end,end,end,


LineNum,inLabel,command,JumpToLabel,jumpToAd,start_row_counter,
Label,StartPoint,EndPoint,Size,log_2,
empty,1,363,362,9,
sha_transform,378,559,181,8,
.LPIC0,567,697,130,8,
.L3,702,981,279,9,
.L2,986,1089,103,7,
.L5,1094,1653,559,10,
.L4,1658,2158,500,9,
.L7,2163,3035,872,10,
.L6,3040,3143,103,7,
.L9,3148,3959,811,10,
.L8,3964,4068,104,7,
.L11,4074,4981,907,10,
.L10,4987,5092,105,7,
.L13,5098,5909,811,10,
.L12,5915,6810,895,10,
.L14,6816,6877,61,6,
.L16,6883,6893,10,4,
.L15,6899,7102,203,8,
byte_reverse,7116,7292,176,8,
.LPIC1,7300,7500,200,8,
.L19,7506,8261,755,10,
.L18,8267,8441,174,8,
.L20,8447,8504,57,6,
.L22,8510,8520,10,4,
.L21,8526,8741,215,8,
sha_init,8751,9583,832,10,
sha_update,9595,10022,427,9,
.L25,10028,10291,263,9,
.L27,10297,10629,332,9,
.L26,10635,10982,347,9,
sha_final,10993,11875,882,10,
.L29,11881,12029,148,8,
.L30,12035,12477,442,9,
sha_stream,12489,12756,267,9,
.LPIC2,12764,12949,185,8,
.L33,12955,13106,151,8,
.L32,13112,13587,475,9,
.L34,13593,13673,80,7,
.L36,13679,13689,10,4,
.L35,13695,13825,130,8,
.LC0,13831,13997,166,8,
sha_print,14008,14407,399,9,
.LPIC3,14415,14509,94,7,
.L39,14515,14525,10,4,
.L38,14531,14531,53,6,
end,end,end,end,


LineNum,inLabel,command,JumpToLabel,jumpToAd,start_row_counter,
Label,StartPoint,EndPoint,Size,log_2,
empty,1,363,362,9,
sha_transform,378,559,181,8,
.LPIC0,567,697,130,8,
.L3,702,981,279,9,
.L2,986,1089,103,7,
.L5,1094,1653,559,10,
.L4,1658,2158,500,9,
.L7,2163,3035,872,10,
.L6,3040,3143,103,7,
.L9,3148,3959,811,10,
.L8,3964,4068,104,7,
.L11,4074,4981,907,10,
.L10,4987,5092,105,7,
.L13,5098,5909,811,10,
.L12,5915,6810,895,10,
.L14,6816,6877,61,6,
.L16,6883,6893,10,4,
.L15,6899,7102,203,8,
byte_reverse,7116,7292,176,8,
.LPIC1,7300,7500,200,8,
.L19,7506,8261,755,10,
.L18,8267,8441,174,8,
.L20,8447,8504,57,6,
.L22,8510,8520,10,4,
.L21,8526,8741,215,8,
sha_init,8751,9583,832,10,
sha_update,9595,10022,427,9,
.L25,10028,10291,263,9,
.L27,10297,10629,332,9,
.L26,10635,10982,347,9,
sha_final,10993,11875,882,10,
.L29,11881,12029,148,8,
.L30,12035,12477,442,9,
sha_stream,12489,12756,267,9,
.LPIC2,12764,12949,185,8,
.L33,12955,13106,151,8,
.L32,13112,13587,475,9,
.L34,13593,13673,80,7,
.L36,13679,13689,10,4,
.L35,13695,13825,130,8,
.LC0,13831,13997,166,8,
sha_print,14008,14407,399,9,
.LPIC3,14415,14509,94,7,
.L39,14515,14525,10,4,
.L38,14531,14531,53,6,
end,end,end,end,


LineNum,inLabel,command,JumpToLabel,jumpToAd,start_row_counter,
Label,StartPoint,EndPoint,Size,log_2,
empty,1,363,362,9,
sha_transform,378,559,181,8,
.LPIC0,567,697,130,8,
.L3,702,981,279,9,
.L2,986,1089,103,7,
.L5,1094,1653,559,10,
.L4,1658,2158,500,9,
.L7,2163,3035,872,10,
.L6,3040,3143,103,7,
.L9,3148,3959,811,10,
.L8,3964,4068,104,7,
.L11,4074,4981,907,10,
.L10,4987,5092,105,7,
.L13,5098,5909,811,10,
.L12,5915,6810,895,10,
.L14,6816,6877,61,6,
.L16,6883,6893,10,4,
.L15,6899,7102,203,8,
byte_reverse,7116,7292,176,8,
.LPIC1,7300,7500,200,8,
.L19,7506,8261,755,10,
.L18,8267,8441,174,8,
.L20,8447,8504,57,6,
.L22,8510,8520,10,4,
.L21,8526,8741,215,8,
sha_init,8751,9583,832,10,
sha_update,9595,10022,427,9,
.L25,10028,10291,263,9,
.L27,10297,10629,332,9,
.L26,10635,10982,347,9,
sha_final,10993,11875,882,10,
.L29,11881,12029,148,8,
.L30,12035,12477,442,9,
sha_stream,12489,12756,267,9,
.LPIC2,12764,12949,185,8,
.L33,12955,13106,151,8,
.L32,13112,13587,475,9,
.L34,13593,13673,80,7,
.L36,13679,13689,10,4,
.L35,13695,13825,130,8,
.LC0,13831,13997,166,8,
sha_print,14008,14407,399,9,
.LPIC3,14415,14509,94,7,
.L39,14515,14525,10,4,
.L38,14531,14531,53,6,
end,end,end,end,


LineNum,inLabel,command,JumpToLabel,jumpToAd,start_row_counter,
Label,StartPoint,EndPoint,Size,log_2,
empty,1,363,362,9,
sha_transform,378,559,181,8,
.LPIC0,567,697,130,8,
.L3,702,981,279,9,
.L2,986,1089,103,7,
.L5,1094,1653,559,10,
.L4,1658,2158,500,9,
.L7,2163,3035,872,10,
.L6,3040,3143,103,7,
.L9,3148,3959,811,10,
.L8,3964,4068,104,7,
.L11,4074,4981,907,10,
.L10,4987,5092,105,7,
.L13,5098,5909,811,10,
.L12,5915,6810,895,10,
.L14,6816,6877,61,6,
.L16,6883,6893,10,4,
.L15,6899,7102,203,8,
byte_reverse,7116,7292,176,8,
.LPIC1,7300,7500,200,8,
.L19,7506,8261,755,10,
.L18,8267,8441,174,8,
.L20,8447,8504,57,6,
.L22,8510,8520,10,4,
.L21,8526,8741,215,8,
sha_init,8751,9583,832,10,
sha_update,9595,10022,427,9,
.L25,10028,10291,263,9,
.L27,10297,10629,332,9,
.L26,10635,10982,347,9,
sha_final,10993,11875,882,10,
.L29,11881,12029,148,8,
.L30,12035,12477,442,9,
sha_stream,12489,12756,267,9,
.LPIC2,12764,12949,185,8,
.L33,12955,13106,151,8,
.L32,13112,13587,475,9,
.L34,13593,13673,80,7,
.L36,13679,13689,10,4,
.L35,13695,13825,130,8,
.LC0,13831,13997,166,8,
sha_print,14008,14407,399,9,
.LPIC3,14415,14509,94,7,
.L39,14515,14525,10,4,
.L38,14531,14531,53,6,
end,end,end,end,


LineNum,inLabel,command,JumpToLabel,jumpToAd,start_row_counter,
Label,StartPoint,EndPoint,Size,log_2,
empty,1,363,362,9,
sha_transform,378,559,181,8,
.LPIC0,567,697,130,8,
.L3,702,981,279,9,
.L2,986,1089,103,7,
.L5,1094,1653,559,10,
.L4,1658,2158,500,9,
.L7,2163,3035,872,10,
.L6,3040,3143,103,7,
.L9,3148,3959,811,10,
.L8,3964,4068,104,7,
.L11,4074,4981,907,10,
.L10,4987,5092,105,7,
.L13,5098,5909,811,10,
.L12,5915,6810,895,10,
.L14,6816,6877,61,6,
.L16,6883,6893,10,4,
.L15,6899,7102,203,8,
byte_reverse,7116,7292,176,8,
.LPIC1,7300,7500,200,8,
.L19,7506,8261,755,10,
.L18,8267,8441,174,8,
.L20,8447,8504,57,6,
.L22,8510,8520,10,4,
.L21,8526,8741,215,8,
sha_init,8751,9583,832,10,
sha_update,9595,10022,427,9,
.L25,10028,10291,263,9,
.L27,10297,10629,332,9,
.L26,10635,10982,347,9,
sha_final,10993,11875,882,10,
.L29,11881,12029,148,8,
.L30,12035,12477,442,9,
sha_stream,12489,12756,267,9,
.LPIC2,12764,12949,185,8,
.L33,12955,13106,151,8,
.L32,13112,13587,475,9,
.L34,13593,13673,80,7,
.L36,13679,13689,10,4,
.L35,13695,13825,130,8,
.LC0,13831,13997,166,8,
sha_print,14008,14407,399,9,
.LPIC3,14415,14509,94,7,
.L39,14515,14525,10,4,
.L38,14531,14531,53,6,
end,end,end,end,


LineNum,inLabel,command,JumpToLabel,jumpToAd,start_row_counter,
Label,StartPoint,EndPoint,Size,log_2,
empty,1,363,362,9,
sha_transform,378,559,181,8,
.LPIC0,567,697,130,8,
.L3,702,981,279,9,
.L2,986,1089,103,7,
.L5,1094,1653,559,10,
.L4,1658,2158,500,9,
.L7,2163,3035,872,10,
.L6,3040,3143,103,7,
.L9,3148,3959,811,10,
.L8,3964,4068,104,7,
.L11,4074,4981,907,10,
.L10,4987,5092,105,7,
.L13,5098,5909,811,10,
.L12,5915,6810,895,10,
.L14,6816,6877,61,6,
.L16,6883,6893,10,4,
.L15,6899,7102,203,8,
byte_reverse,7116,7292,176,8,
.LPIC1,7300,7500,200,8,
.L19,7506,8261,755,10,
.L18,8267,8441,174,8,
.L20,8447,8504,57,6,
.L22,8510,8520,10,4,
.L21,8526,8741,215,8,
sha_init,8751,9583,832,10,
sha_update,9595,10022,427,9,
.L25,10028,10291,263,9,
.L27,10297,10629,332,9,
.L26,10635,10982,347,9,
sha_final,10993,11875,882,10,
.L29,11881,12029,148,8,
.L30,12035,12477,442,9,
sha_stream,12489,12756,267,9,
.LPIC2,12764,12949,185,8,
.L33,12955,13106,151,8,
.L32,13112,13587,475,9,
.L34,13593,13673,80,7,
.L36,13679,13689,10,4,
.L35,13695,13825,130,8,
.LC0,13831,13997,166,8,
sha_print,14008,14407,399,9,
.LPIC3,14415,14509,94,7,
.L39,14515,14525,10,4,
.L38,14531,14531,53,6,
end,end,end,end,


LineNum,inLabel,command,JumpToLabel,jumpToAd,start_row_counter,
Label,StartPoint,EndPoint,Size,log_2,
empty,1,363,362,9,
sha_transform,378,559,181,8,
.LPIC0,567,697,130,8,
.L3,702,981,279,9,
.L2,986,1089,103,7,
.L5,1094,1653,559,10,
.L4,1658,2158,500,9,
.L7,2163,3035,872,10,
.L6,3040,3143,103,7,
.L9,3148,3959,811,10,
.L8,3964,4068,104,7,
.L11,4074,4981,907,10,
.L10,4987,5092,105,7,
.L13,5098,5909,811,10,
.L12,5915,6810,895,10,
.L14,6816,6877,61,6,
.L16,6883,6893,10,4,
.L15,6899,7102,203,8,
byte_reverse,7116,7292,176,8,
.LPIC1,7300,7500,200,8,
.L19,7506,8261,755,10,
.L18,8267,8441,174,8,
.L20,8447,8504,57,6,
.L22,8510,8520,10,4,
.L21,8526,8741,215,8,
sha_init,8751,9583,832,10,
sha_update,9595,10022,427,9,
.L25,10028,10291,263,9,
.L27,10297,10629,332,9,
.L26,10635,10982,347,9,
sha_final,10993,11875,882,10,
.L29,11881,12029,148,8,
.L30,12035,12477,442,9,
sha_stream,12489,12756,267,9,
.LPIC2,12764,12949,185,8,
.L33,12955,13106,151,8,
.L32,13112,13587,475,9,
.L34,13593,13673,80,7,
.L36,13679,13689,10,4,
.L35,13695,13825,130,8,
.LC0,13831,13997,166,8,
sha_print,14008,14407,399,9,
.LPIC3,14415,14509,94,7,
.L39,14515,14525,10,4,
.L38,14531,14531,53,6,
end,end,end,end,


LineNum,inLabel,command,JumpToLabel,jumpToAd,start_row_counter,
Label,StartPoint,EndPoint,Size,log_2,
empty,1,363,362,9,
sha_transform,378,559,181,8,
.LPIC0,567,697,130,8,
.L3,702,981,279,9,
.L2,986,1089,103,7,
.L5,1094,1653,559,10,
.L4,1658,2158,500,9,
.L7,2163,3035,872,10,
.L6,3040,3143,103,7,
.L9,3148,3959,811,10,
.L8,3964,4068,104,7,
.L11,4074,4981,907,10,
.L10,4987,5092,105,7,
.L13,5098,5909,811,10,
.L12,5915,6810,895,10,
.L14,6816,6877,61,6,
.L16,6883,6893,10,4,
.L15,6899,7102,203,8,
byte_reverse,7116,7292,176,8,
.LPIC1,7300,7500,200,8,
.L19,7506,8261,755,10,
.L18,8267,8441,174,8,
.L20,8447,8504,57,6,
.L22,8510,8520,10,4,
.L21,8526,8741,215,8,
sha_init,8751,9583,832,10,
sha_update,9595,10022,427,9,
.L25,10028,10291,263,9,
.L27,10297,10629,332,9,
.L26,10635,10982,347,9,
sha_final,10993,11875,882,10,
.L29,11881,12029,148,8,
.L30,12035,12477,442,9,
sha_stream,12489,12756,267,9,
.LPIC2,12764,12949,185,8,
.L33,12955,13106,151,8,
.L32,13112,13587,475,9,
.L34,13593,13673,80,7,
.L36,13679,13689,10,4,
.L35,13695,13825,130,8,
.LC0,13831,13997,166,8,
sha_print,14008,14407,399,9,
.LPIC3,14415,14509,94,7,
.L39,14515,14525,10,4,
.L38,14531,14531,53,6,
end,end,end,end,


LineNum,inLabel,command,JumpToLabel,jumpToAd,start_row_counter,
Label,StartPoint,EndPoint,Size,log_2,
empty,1,363,362,9,
sha_transform,378,559,181,8,
.LPIC0,567,697,130,8,
.L3,702,981,279,9,
.L2,986,1089,103,7,
.L5,1094,1653,559,10,
.L4,1658,2158,500,9,
.L7,2163,3035,872,10,
.L6,3040,3143,103,7,
.L9,3148,3959,811,10,
.L8,3964,4068,104,7,
.L11,4074,4981,907,10,
.L10,4987,5092,105,7,
.L13,5098,5909,811,10,
.L12,5915,6810,895,10,
.L14,6816,6877,61,6,
.L16,6883,6893,10,4,
.L15,6899,7102,203,8,
byte_reverse,7116,7292,176,8,
.LPIC1,7300,7500,200,8,
.L19,7506,8261,755,10,
.L18,8267,8441,174,8,
.L20,8447,8504,57,6,
.L22,8510,8520,10,4,
.L21,8526,8741,215,8,
sha_init,8751,9583,832,10,
sha_update,9595,10022,427,9,
.L25,10028,10291,263,9,
.L27,10297,10629,332,9,
.L26,10635,10982,347,9,
sha_final,10993,11875,882,10,
.L29,11881,12029,148,8,
.L30,12035,12477,442,9,
sha_stream,12489,12756,267,9,
.LPIC2,12764,12949,185,8,
.L33,12955,13106,151,8,
.L32,13112,13587,475,9,
.L34,13593,13673,80,7,
.L36,13679,13689,10,4,
.L35,13695,13825,130,8,
.LC0,13831,13997,166,8,
sha_print,14008,14407,399,9,
.LPIC3,14415,14509,94,7,
.L39,14515,14525,10,4,
.L38,14531,14531,53,6,
end,end,end,end,


LineNum,inLabel,command,JumpToLabel,jumpToAd,start_row_counter,
Label,StartPoint,EndPoint,Size,log_2,
empty,1,363,362,9,
sha_transform,378,559,181,8,
.LPIC0,567,697,130,8,
.L3,702,981,279,9,
.L2,986,1089,103,7,
.L5,1094,1653,559,10,
.L4,1658,2158,500,9,
.L7,2163,3035,872,10,
.L6,3040,3143,103,7,
.L9,3148,3959,811,10,
.L8,3964,4068,104,7,
.L11,4074,4981,907,10,
.L10,4987,5092,105,7,
.L13,5098,5909,811,10,
.L12,5915,6810,895,10,
.L14,6816,6877,61,6,
.L16,6883,6893,10,4,
.L15,6899,7102,203,8,
byte_reverse,7116,7292,176,8,
.LPIC1,7300,7500,200,8,
.L19,7506,8261,755,10,
.L18,8267,8441,174,8,
.L20,8447,8504,57,6,
.L22,8510,8520,10,4,
.L21,8526,8741,215,8,
sha_init,8751,9583,832,10,
sha_update,9595,10022,427,9,
.L25,10028,10291,263,9,
.L27,10297,10629,332,9,
.L26,10635,10982,347,9,
sha_final,10993,11875,882,10,
.L29,11881,12029,148,8,
.L30,12035,12477,442,9,
sha_stream,12489,12756,267,9,
.LPIC2,12764,12949,185,8,
.L33,12955,13106,151,8,
.L32,13112,13587,475,9,
.L34,13593,13673,80,7,
.L36,13679,13689,10,4,
.L35,13695,13825,130,8,
.LC0,13831,13997,166,8,
sha_print,14008,14407,399,9,
.LPIC3,14415,14509,94,7,
.L39,14515,14525,10,4,
.L38,14531,14531,53,6,
end,end,end,end,


LineNum,inLabel,command,JumpToLabel,jumpToAd,start_row_counter,
Label,StartPoint,EndPoint,Size,log_2,
empty,1,363,362,9,
sha_transform,378,559,181,8,
.LPIC0,567,697,130,8,
.L3,702,981,279,9,
.L2,986,1089,103,7,
.L5,1094,1653,559,10,
.L4,1658,2158,500,9,
.L7,2163,3035,872,10,
.L6,3040,3143,103,7,
.L9,3148,3959,811,10,
.L8,3964,4068,104,7,
.L11,4074,4981,907,10,
.L10,4987,5092,105,7,
.L13,5098,5909,811,10,
.L12,5915,6810,895,10,
.L14,6816,6877,61,6,
.L16,6883,6893,10,4,
.L15,6899,7102,203,8,
byte_reverse,7116,7292,176,8,
.LPIC1,7300,7500,200,8,
.L19,7506,8261,755,10,
.L18,8267,8441,174,8,
.L20,8447,8504,57,6,
.L22,8510,8520,10,4,
.L21,8526,8741,215,8,
sha_init,8751,9583,832,10,
sha_update,9595,10022,427,9,
.L25,10028,10291,263,9,
.L27,10297,10629,332,9,
.L26,10635,10982,347,9,
sha_final,10993,11875,882,10,
.L29,11881,12029,148,8,
.L30,12035,12477,442,9,
sha_stream,12489,12756,267,9,
.LPIC2,12764,12949,185,8,
.L33,12955,13106,151,8,
.L32,13112,13587,475,9,
.L34,13593,13673,80,7,
.L36,13679,13689,10,4,
.L35,13695,13825,130,8,
.LC0,13831,13997,166,8,
sha_print,14008,14407,399,9,
.LPIC3,14415,14509,94,7,
.L39,14515,14525,10,4,
.L38,14531,14531,53,6,
end,end,end,end,


LineNum,inLabel,command,JumpToLabel,jumpToAd,start_row_counter,
Label,StartPoint,EndPoint,Size,log_2,
empty,1,363,362,9,
sha_transform,378,559,181,8,
.LPIC0,567,697,130,8,
.L3,702,981,279,9,
.L2,986,1089,103,7,
.L5,1094,1653,559,10,
.L4,1658,2158,500,9,
.L7,2163,3035,872,10,
.L6,3040,3143,103,7,
.L9,3148,3959,811,10,
.L8,3964,4068,104,7,
.L11,4074,4981,907,10,
.L10,4987,5092,105,7,
.L13,5098,5909,811,10,
.L12,5915,6810,895,10,
.L14,6816,6877,61,6,
.L16,6883,6893,10,4,
.L15,6899,7102,203,8,
byte_reverse,7116,7292,176,8,
.LPIC1,7300,7500,200,8,
.L19,7506,8261,755,10,
.L18,8267,8441,174,8,
.L20,8447,8504,57,6,
.L22,8510,8520,10,4,
.L21,8526,8741,215,8,
sha_init,8751,9583,832,10,
sha_update,9595,10022,427,9,
.L25,10028,10291,263,9,
.L27,10297,10629,332,9,
.L26,10635,10982,347,9,
sha_final,10993,11875,882,10,
.L29,11881,12029,148,8,
.L30,12035,12477,442,9,
sha_stream,12489,12756,267,9,
.LPIC2,12764,12949,185,8,
.L33,12955,13106,151,8,
.L32,13112,13587,475,9,
.L34,13593,13673,80,7,
.L36,13679,13689,10,4,
.L35,13695,13825,130,8,
.LC0,13831,13997,166,8,
sha_print,14008,14407,399,9,
.LPIC3,14415,14509,94,7,
.L39,14515,14525,10,4,
.L38,14531,14531,53,6,
end,end,end,end,


LineNum,inLabel,command,JumpToLabel,jumpToAd,start_row_counter,
Label,StartPoint,EndPoint,Size,log_2,
empty,1,363,362,9,
sha_transform,378,559,181,8,
.LPIC0,567,697,130,8,
.L3,702,981,279,9,
.L2,986,1089,103,7,
.L5,1094,1653,559,10,
.L4,1658,2158,500,9,
.L7,2163,3035,872,10,
.L6,3040,3143,103,7,
.L9,3148,3959,811,10,
.L8,3964,4068,104,7,
.L11,4074,4981,907,10,
.L10,4987,5092,105,7,
.L13,5098,5909,811,10,
.L12,5915,6810,895,10,
.L14,6816,6877,61,6,
.L16,6883,6893,10,4,
.L15,6899,7102,203,8,
byte_reverse,7116,7292,176,8,
.LPIC1,7300,7500,200,8,
.L19,7506,8261,755,10,
.L18,8267,8441,174,8,
.L20,8447,8504,57,6,
.L22,8510,8520,10,4,
.L21,8526,8741,215,8,
sha_init,8751,9583,832,10,
sha_update,9595,10022,427,9,
.L25,10028,10291,263,9,
.L27,10297,10629,332,9,
.L26,10635,10982,347,9,
sha_final,10993,11875,882,10,
.L29,11881,12029,148,8,
.L30,12035,12477,442,9,
sha_stream,12489,12756,267,9,
.LPIC2,12764,12949,185,8,
.L33,12955,13106,151,8,
.L32,13112,13587,475,9,
.L34,13593,13673,80,7,
.L36,13679,13689,10,4,
.L35,13695,13825,130,8,
.LC0,13831,13997,166,8,
sha_print,14008,14407,399,9,
.LPIC3,14415,14509,94,7,
.L39,14515,14525,10,4,
.L38,14531,14531,53,6,
end,end,end,end,


LineNum,inLabel,command,JumpToLabel,jumpToAd,start_row_counter,
Label,StartPoint,EndPoint,Size,log_2,
empty,1,363,362,9,
sha_transform,378,559,181,8,
.LPIC0,567,697,130,8,
.L3,702,981,279,9,
.L2,986,1089,103,7,
.L5,1094,1653,559,10,
.L4,1658,2158,500,9,
.L7,2163,3035,872,10,
.L6,3040,3143,103,7,
.L9,3148,3959,811,10,
.L8,3964,4068,104,7,
.L11,4074,4981,907,10,
.L10,4987,5092,105,7,
.L13,5098,5909,811,10,
.L12,5915,6810,895,10,
.L14,6816,6877,61,6,
.L16,6883,6893,10,4,
.L15,6899,7102,203,8,
byte_reverse,7116,7292,176,8,
.LPIC1,7300,7500,200,8,
.L19,7506,8261,755,10,
.L18,8267,8441,174,8,
.L20,8447,8504,57,6,
.L22,8510,8520,10,4,
.L21,8526,8741,215,8,
sha_init,8751,9583,832,10,
sha_update,9595,10022,427,9,
.L25,10028,10291,263,9,
.L27,10297,10629,332,9,
.L26,10635,10982,347,9,
sha_final,10993,11875,882,10,
.L29,11881,12029,148,8,
.L30,12035,12477,442,9,
sha_stream,12489,12756,267,9,
.LPIC2,12764,12949,185,8,
.L33,12955,13106,151,8,
.L32,13112,13587,475,9,
.L34,13593,13673,80,7,
.L36,13679,13689,10,4,
.L35,13695,13825,130,8,
.LC0,13831,13997,166,8,
sha_print,14008,14407,399,9,
.LPIC3,14415,14509,94,7,
.L39,14515,14525,10,4,
.L38,14531,14531,53,6,
end,end,end,end,


LineNum,inLabel,command,JumpToLabel,jumpToAd,start_row_counter,
Label,StartPoint,EndPoint,Size,log_2,
empty,1,363,362,9,
sha_transform,378,559,181,8,
.LPIC0,567,697,130,8,
.L3,702,981,279,9,
.L2,986,1089,103,7,
.L5,1094,1653,559,10,
.L4,1658,2158,500,9,
.L7,2163,3035,872,10,
.L6,3040,3143,103,7,
.L9,3148,3959,811,10,
.L8,3964,4068,104,7,
.L11,4074,4981,907,10,
.L10,4987,5092,105,7,
.L13,5098,5909,811,10,
.L12,5915,6810,895,10,
.L14,6816,6877,61,6,
.L16,6883,6893,10,4,
.L15,6899,7102,203,8,
byte_reverse,7116,7292,176,8,
.LPIC1,7300,7500,200,8,
.L19,7506,8261,755,10,
.L18,8267,8441,174,8,
.L20,8447,8504,57,6,
.L22,8510,8520,10,4,
.L21,8526,8741,215,8,
sha_init,8751,9583,832,10,
sha_update,9595,10022,427,9,
.L25,10028,10291,263,9,
.L27,10297,10629,332,9,
.L26,10635,10982,347,9,
sha_final,10993,11875,882,10,
.L29,11881,12029,148,8,
.L30,12035,12477,442,9,
sha_stream,12489,12756,267,9,
.LPIC2,12764,12949,185,8,
.L33,12955,13106,151,8,
.L32,13112,13587,475,9,
.L34,13593,13673,80,7,
.L36,13679,13689,10,4,
.L35,13695,13825,130,8,
.LC0,13831,13997,166,8,
sha_print,14008,14407,399,9,
.LPIC3,14415,14509,94,7,
.L39,14515,14525,10,4,
.L38,14531,14531,53,6,
end,end,end,end,


LineNum,inLabel,command,JumpToLabel,jumpToAd,start_row_counter,
Label,StartPoint,EndPoint,Size,log_2,
empty,1,363,362,9,
sha_transform,378,559,181,8,
.LPIC0,567,697,130,8,
.L3,702,981,279,9,
.L2,986,1089,103,7,
.L5,1094,1653,559,10,
.L4,1658,2158,500,9,
.L7,2163,3035,872,10,
.L6,3040,3143,103,7,
.L9,3148,3959,811,10,
.L8,3964,4068,104,7,
.L11,4074,4981,907,10,
.L10,4987,5092,105,7,
.L13,5098,5909,811,10,
.L12,5915,6810,895,10,
.L14,6816,6877,61,6,
.L16,6883,6893,10,4,
.L15,6899,7102,203,8,
byte_reverse,7116,7292,176,8,
.LPIC1,7300,7500,200,8,
.L19,7506,8261,755,10,
.L18,8267,8441,174,8,
.L20,8447,8504,57,6,
.L22,8510,8520,10,4,
.L21,8526,8741,215,8,
sha_init,8751,9583,832,10,
sha_update,9595,10022,427,9,
.L25,10028,10291,263,9,
.L27,10297,10629,332,9,
.L26,10635,10982,347,9,
sha_final,10993,11875,882,10,
.L29,11881,12029,148,8,
.L30,12035,12477,442,9,
sha_stream,12489,12756,267,9,
.LPIC2,12764,12949,185,8,
.L33,12955,13106,151,8,
.L32,13112,13587,475,9,
.L34,13593,13673,80,7,
.L36,13679,13689,10,4,
.L35,13695,13825,130,8,
.LC0,13831,13997,166,8,
sha_print,14008,14407,399,9,
.LPIC3,14415,14509,94,7,
.L39,14515,14525,10,4,
.L38,14531,14531,53,6,
end,end,end,end,


LineNum,inLabel,command,JumpToLabel,jumpToAd,start_row_counter,
Label,StartPoint,EndPoint,Size,log_2,
empty,1,363,362,9,
sha_transform,378,559,181,8,
.LPIC0,567,697,130,8,
.L3,702,981,279,9,
.L2,986,1089,103,7,
.L5,1094,1653,559,10,
.L4,1658,2158,500,9,
.L7,2163,3035,872,10,
.L6,3040,3143,103,7,
.L9,3148,3959,811,10,
.L8,3964,4068,104,7,
.L11,4074,4981,907,10,
.L10,4987,5092,105,7,
.L13,5098,5909,811,10,
.L12,5915,6810,895,10,
.L14,6816,6877,61,6,
.L16,6883,6893,10,4,
.L15,6899,7102,203,8,
byte_reverse,7116,7292,176,8,
.LPIC1,7300,7500,200,8,
.L19,7506,8261,755,10,
.L18,8267,8441,174,8,
.L20,8447,8504,57,6,
.L22,8510,8520,10,4,
.L21,8526,8741,215,8,
sha_init,8751,9583,832,10,
sha_update,9595,10022,427,9,
.L25,10028,10291,263,9,
.L27,10297,10629,332,9,
.L26,10635,10982,347,9,
sha_final,10993,11875,882,10,
.L29,11881,12029,148,8,
.L30,12035,12477,442,9,
sha_stream,12489,12756,267,9,
.LPIC2,12764,12949,185,8,
.L33,12955,13106,151,8,
.L32,13112,13587,475,9,
.L34,13593,13673,80,7,
.L36,13679,13689,10,4,
.L35,13695,13825,130,8,
.LC0,13831,13997,166,8,
sha_print,14008,14407,399,9,
.LPIC3,14415,14509,94,7,
.L39,14515,14525,10,4,
.L38,14531,14531,53,6,
end,end,end,end,


LineNum,inLabel,command,JumpToLabel,jumpToAd,start_row_counter,
Label,StartPoint,EndPoint,Size,log_2,
empty,1,363,362,9,
sha_transform,378,559,181,8,
.LPIC0,567,697,130,8,
.L3,702,981,279,9,
.L2,986,1089,103,7,
.L5,1094,1653,559,10,
.L4,1658,2158,500,9,
.L7,2163,3035,872,10,
.L6,3040,3143,103,7,
.L9,3148,3959,811,10,
.L8,3964,4068,104,7,
.L11,4074,4981,907,10,
.L10,4987,5092,105,7,
.L13,5098,5909,811,10,
.L12,5915,6810,895,10,
.L14,6816,6877,61,6,
.L16,6883,6893,10,4,
.L15,6899,7102,203,8,
byte_reverse,7116,7292,176,8,
.LPIC1,7300,7500,200,8,
.L19,7506,8261,755,10,
.L18,8267,8441,174,8,
.L20,8447,8504,57,6,
.L22,8510,8520,10,4,
.L21,8526,8741,215,8,
sha_init,8751,9583,832,10,
sha_update,9595,10022,427,9,
.L25,10028,10291,263,9,
.L27,10297,10629,332,9,
.L26,10635,10982,347,9,
sha_final,10993,11875,882,10,
.L29,11881,12029,148,8,
.L30,12035,12477,442,9,
sha_stream,12489,12756,267,9,
.LPIC2,12764,12949,185,8,
.L33,12955,13106,151,8,
.L32,13112,13587,475,9,
.L34,13593,13673,80,7,
.L36,13679,13689,10,4,
.L35,13695,13825,130,8,
.LC0,13831,13997,166,8,
sha_print,14008,14407,399,9,
.LPIC3,14415,14509,94,7,
.L39,14515,14525,10,4,
.L38,14531,14531,53,6,
end,end,end,end,


LineNum,inLabel,command,JumpToLabel,jumpToAd,start_row_counter,
Label,StartPoint,EndPoint,Size,log_2,
empty,1,363,362,9,
sha_transform,378,559,181,8,
.LPIC0,567,697,130,8,
.L3,702,981,279,9,
.L2,986,1089,103,7,
.L5,1094,1653,559,10,
.L4,1658,2158,500,9,
.L7,2163,3035,872,10,
.L6,3040,3143,103,7,
.L9,3148,3959,811,10,
.L8,3964,4068,104,7,
.L11,4074,4981,907,10,
.L10,4987,5092,105,7,
.L13,5098,5909,811,10,
.L12,5915,6810,895,10,
.L14,6816,6877,61,6,
.L16,6883,6893,10,4,
.L15,6899,7102,203,8,
byte_reverse,7116,7292,176,8,
.LPIC1,7300,7500,200,8,
.L19,7506,8261,755,10,
.L18,8267,8441,174,8,
.L20,8447,8504,57,6,
.L22,8510,8520,10,4,
.L21,8526,8741,215,8,
sha_init,8751,9583,832,10,
sha_update,9595,10022,427,9,
.L25,10028,10291,263,9,
.L27,10297,10629,332,9,
.L26,10635,10982,347,9,
sha_final,10993,11875,882,10,
.L29,11881,12029,148,8,
.L30,12035,12477,442,9,
sha_stream,12489,12756,267,9,
.LPIC2,12764,12949,185,8,
.L33,12955,13106,151,8,
.L32,13112,13587,475,9,
.L34,13593,13673,80,7,
.L36,13679,13689,10,4,
.L35,13695,13825,130,8,
.LC0,13831,13997,166,8,
sha_print,14008,14407,399,9,
.LPIC3,14415,14509,94,7,
.L39,14515,14525,10,4,
.L38,14531,14531,53,6,
end,end,end,end,


LineNum,inLabel,command,JumpToLabel,jumpToAd,start_row_counter,
Label,StartPoint,EndPoint,Size,log_2,
empty,1,363,362,9,
sha_transform,378,559,181,8,
.LPIC0,567,697,130,8,
.L3,702,981,279,9,
.L2,986,1089,103,7,
.L5,1094,1653,559,10,
.L4,1658,2158,500,9,
.L7,2163,3035,872,10,
.L6,3040,3143,103,7,
.L9,3148,3959,811,10,
.L8,3964,4068,104,7,
.L11,4074,4981,907,10,
.L10,4987,5092,105,7,
.L13,5098,5909,811,10,
.L12,5915,6810,895,10,
.L14,6816,6877,61,6,
.L16,6883,6893,10,4,
.L15,6899,7102,203,8,
byte_reverse,7116,7292,176,8,
.LPIC1,7300,7500,200,8,
.L19,7506,8261,755,10,
.L18,8267,8441,174,8,
.L20,8447,8504,57,6,
.L22,8510,8520,10,4,
.L21,8526,8741,215,8,
sha_init,8751,9583,832,10,
sha_update,9595,10022,427,9,
.L25,10028,10291,263,9,
.L27,10297,10629,332,9,
.L26,10635,10982,347,9,
sha_final,10993,11875,882,10,
.L29,11881,12029,148,8,
.L30,12035,12477,442,9,
sha_stream,12489,12756,267,9,
.LPIC2,12764,12949,185,8,
.L33,12955,13106,151,8,
.L32,13112,13587,475,9,
.L34,13593,13673,80,7,
.L36,13679,13689,10,4,
.L35,13695,13825,130,8,
.LC0,13831,13997,166,8,
sha_print,14008,14407,399,9,
.LPIC3,14415,14509,94,7,
.L39,14515,14525,10,4,
.L38,14531,14531,53,6,
end,end,end,end,


LineNum,inLabel,command,JumpToLabel,jumpToAd,start_row_counter,
Label,StartPoint,EndPoint,Size,log_2,
empty,1,363,362,9,
sha_transform,378,559,181,8,
.LPIC0,567,697,130,8,
.L3,702,981,279,9,
.L2,986,1089,103,7,
.L5,1094,1653,559,10,
.L4,1658,2158,500,9,
.L7,2163,3035,872,10,
.L6,3040,3143,103,7,
.L9,3148,3959,811,10,
.L8,3964,4068,104,7,
.L11,4074,4981,907,10,
.L10,4987,5092,105,7,
.L13,5098,5909,811,10,
.L12,5915,6810,895,10,
.L14,6816,6877,61,6,
.L16,6883,6893,10,4,
.L15,6899,7102,203,8,
byte_reverse,7116,7292,176,8,
.LPIC1,7300,7500,200,8,
.L19,7506,8261,755,10,
.L18,8267,8441,174,8,
.L20,8447,8504,57,6,
.L22,8510,8520,10,4,
.L21,8526,8741,215,8,
sha_init,8751,9583,832,10,
sha_update,9595,10022,427,9,
.L25,10028,10291,263,9,
.L27,10297,10629,332,9,
.L26,10635,10982,347,9,
sha_final,10993,11875,882,10,
.L29,11881,12029,148,8,
.L30,12035,12477,442,9,
sha_stream,12489,12756,267,9,
.LPIC2,12764,12949,185,8,
.L33,12955,13106,151,8,
.L32,13112,13587,475,9,
.L34,13593,13673,80,7,
.L36,13679,13689,10,4,
.L35,13695,13825,130,8,
.LC0,13831,13997,166,8,
sha_print,14008,14407,399,9,
.LPIC3,14415,14509,94,7,
.L39,14515,14525,10,4,
.L38,14531,14531,53,6,
end,end,end,end,


LineNum,inLabel,command,JumpToLabel,jumpToAd,start_row_counter,
